Year,Town Code,Town,Census Units,Government Assisted,Tenant Rental Assistance, Single Family CHFA/ USDA Mortgages,Deed Restricted Units,Total Assisted Units,Percent Affordable
2020,1,Andover,1317,18,1,32,0,51,3.87
2020,2,Ansonia,8148,349,764,147,0,1260,15.46
2020,3,Ashford,1903,32,0,36,0,68,3.57
2020,4,Avon,7389,244,16,44,0,304,4.11
2020,5,Barkhamsted,1589,0,6,23,0,29,1.83
2020,6,Beacon Falls,2509,0,4,46,0,50,1.99
2020,7,Berlin,8140,556,50,142,4,752,9.24
2020,8,Bethany,2044,0,2,13,0,15,0.73
2020,9,Bethel,7310,192,26,154,87,459,6.28
2020,10,Bethlehem,1575,24,0,9,0,33,2.10
2020,11,Bloomfield,9019,558,106,341,0,1005,11.14
2020,12,Bolton,2015,0,2,28,0,30,1.49
2020,13,Bozrah,1059,0,3,30,0,33,3.12
2020,14,Branford,13972,233,77,170,9,489,3.50
2020,15,Bridgeport,57012,6505,4353,900,19,11777,20.66
2020,16,Bridgewater,881,0,24,1,0,25,2.84
2020,17,Bristol,27011,1908,962,1124,0,3994,14.79
2020,18,Brookfield,6562,155,27,110,77,369,5.62
2020,19,Brooklyn,3235,189,9,65,0,263,8.13
2020,20,Burlington,3389,27,0,47,0,74,2.18
2020,21,Canaan,779,1,4,5,1,11,1.41
2020,22,Canterbury,2043,76,1,68,0,145,7.10
2020,23,Canton,4339,211,15,53,32,311,7.17
2020,24,Chaplin,988,0,1,37,0,38,3.85
2020,25,Cheshire,10424,258,22,100,17,397,3.81
2020,26,Chester,1923,23,3,16,0,42,2.18
2020,27,Clinton,6065,105,8,66,0,179,2.95
2020,28,Colchester,6182,364,38,146,4,552,8.93
2020,29,Colebrook,722,0,1,7,1,9,1.25
2020,30,Columbia,2308,24,2,62,0,88,3.81
2020,31,Cornwall,1007,28,2,6,0,36,3.57
2020,32,Coventry,5099,103,5,131,20,259,5.08
2020,33,Cromwell,6001,212,11,198,0,421,7.02
2020,34,Danbury,31154,1615,1269,565,289,3738,12.00
2020,35,Darien,7074,136,10,2,104,252,3.56
2020,36,Deep River,2096,26,6,32,0,64,3.05
2020,37,Derby,5849,275,301,111,0,687,11.75
2020,38,Durham,2694,36,1,28,0,65,2.41
2020,40,East Granby,2152,72,2,48,0,122,5.67
2020,41,East Haddam,4508,73,3,63,0,139,3.08
2020,42,East Hampton,5485,70,6,91,25,192,3.50
2020,43,East Hartford,21328,1593,815,1035,0,3443,16.14
2020,44,East Haven,12533,542,168,302,0,1012,8.07
2020,45,East Lyme,8458,396,20,95,19,530,6.27
2020,47,East Windsor,5045,559,42,116,0,717,14.21
2020,39,Eastford,793,0,0,15,0,15,1.89
2020,46,Easton,2715,0,0,3,15,18,0.66
2020,48,Ellington,6665,260,5,118,0,383,5.75
2020,49,Enfield,17558,1340,227,659,7,2233,12.72
2020,50,Essex,3261,58,2,17,16,93,2.85
2020,51,Fairfield,21648,231,131,70,124,556,2.57
2020,52,Farmington,11106,470,107,149,155,881,7.93
2020,53,Franklin,771,27,2,20,0,49,6.36
2020,54,Glastonbury,13656,604,44,133,2,783,5.73
2020,55,Goshen,1664,1,1,5,0,7,0.42
2020,56,Granby,4360,85,2,51,5,143,3.28
2020,57,Greenwich,25631,879,443,16,33,1371,5.35
2020,58,Griswold,5118,137,54,158,0,349,6.82
2020,59,Groton,17978,3727,107,377,10,4221,23.48
2020,60,Guilford,9596,186,10,34,0,230,2.40
2020,61,Haddam,3504,22,1,31,0,54,1.54
2020,62,Hamden,25114,937,788,523,4,2252,8.97
2020,63,Hampton,793,0,1,11,0,12,1.51
2020,64,Hartford,51822,10501,8635,1523,0,20659,39.87
2020,65,Hartland,856,2,0,8,0,10,1.17
2020,66,Harwinton,2282,22,5,36,5,68,2.98
2020,67,Hebron,3567,56,3,51,0,110,3.08
2020,68,Kent,1665,58,4,5,0,67,4.02
2020,69,Killingly,7592,520,147,188,0,855,11.26
2020,70,Killingworth,2598,0,0,18,5,23,0.89
2020,71,Lebanon,3125,26,3,84,0,113,3.62
2020,72,Ledyard,5987,32,8,233,0,273,4.56
2020,73,Lisbon,1730,2,0,59,0,61,3.53
2020,74,Litchfield,3975,140,2,28,19,189,4.75
2020,75,Lyme,1223,0,0,5,8,13,1.06
2020,76,Madison,8049,90,2,11,33,136,1.69
2020,77,Manchester,25996,1851,950,964,32,3797,14.61
2020,78,Mansfield,6017,175,124,96,2,397,6.60
2020,79,Marlborough,2389,24,0,24,0,48,2.01
2020,80,Meriden,25892,1964,1270,1029,11,4274,16.51
2020,81,Middlebury,2892,77,5,25,20,127,4.39
2020,82,Middlefield,1863,30,3,21,1,55,2.95
2020,83,Middletown,21223,3019,1123,543,25,4710,22.19
2020,84,Milford,23074,726,208,192,74,1200,5.20
2020,85,Monroe,6918,35,3,54,8,100,1.45
2020,86,Montville,7407,81,58,267,0,406,5.48
2020,87,Morris,1314,20,4,8,0,32,2.44
2020,88,Naugatuck,13061,493,315,367,0,1175,9.00
2020,89,New Britain,31226,2913,1583,1167,100,5763,18.46
2020,90,New Canaan,7551,175,21,5,21,222,2.94
2020,91,New Fairfield,5593,0,1,67,17,85,1.52
2020,92,New Hartford,2923,12,4,55,15,86,2.94
2020,93,New Haven,54967,9511,6867,982,440,17800,32.38
2020,95,New London,11840,1598,510,509,101,2718,22.96
2020,96,New Milford,11731,307,44,182,17,550,4.69
2020,94,Newington,13011,531,122,479,36,1168,8.98
2020,97,Newtown,10061,134,7,95,32,268,2.66
2020,98,Norfolk,967,21,2,5,0,28,2.90
2020,99,North Branford,5629,62,13,52,0,127,2.26
2020,100,North Canaan,1587,148,0,14,0,162,10.21
2020,101,North Haven,9491,393,53,97,23,566,5.96
2020,102,North Stonington,2306,0,1,27,6,34,1.47
2020,103,Norwalk,35415,2242,1468,437,635,4782,13.50
2020,104,Norwich,18659,2249,794,567,0,3610,19.35
2020,105,Old Lyme,5021,60,2,20,3,85,1.69
2020,106,Old Saybrook,5602,50,15,25,73,163,2.91
2020,107,Orange,5345,46,9,12,6,73,1.37
2020,108,Oxford,4746,36,2,31,0,69,1.45
2020,109,Plainfield,6229,377,190,224,0,791,12.70
2020,110,Plainville,8063,205,41,306,22,574,7.12
2020,111,Plymouth,5109,178,21,196,0,395,7.73
2020,112,Pomfret,1684,32,5,13,0,50,2.97
2020,113,Portland,4077,185,94,70,0,349,8.56
2020,114,Preston,2019,40,7,40,0,87,4.31
2020,115,Prospect,3474,0,6,56,0,62,1.78
2020,116,Putnam,4299,383,64,77,0,524,12.19
2020,117,Redding,3811,0,1,17,0,18,0.47
2020,118,Ridgefield,9420,175,7,36,69,287,3.05
2020,119,Rocky Hill,8843,235,52,194,0,481,5.44
2020,120,Roxbury,1167,19,0,5,0,24,2.06
2020,121,Salem,1635,0,3,34,0,37,2.26
2020,122,Salisbury,2593,24,2,2,14,42,1.62
2020,123,Scotland,680,0,1,31,0,32,4.71
2020,124,Seymour,6968,262,28,113,0,403,5.78
2020,125,Sharon,1775,32,1,3,0,36,2.03
2020,126,Shelton,16146,254,45,137,82,518,3.21
2020,127,Sherman,1831,0,1,7,0,8,0.44
2020,128,Simsbury,9123,289,60,98,0,447,4.90
2020,129,Somers,3479,146,9,35,0,190,5.46
2020,132,South Windsor,10243,443,55,232,9,739,7.21
2020,130,Southbury,9091,90,6,41,0,137,1.51
2020,131,Southington,17447,499,63,354,51,967,5.54
2020,133,Sprague,1248,20,13,27,1,61,4.89
2020,134,Stafford,5124,257,22,127,0,406,7.92
2020,135,Stamford,50573,4225,1971,450,1270,7916,15.65
2020,136,Sterling,1511,0,7,24,0,31,2.05
2020,137,Stonington,9467,441,16,97,0,554,5.85
2020,138,Stratford,21091,524,460,373,33,1390,6.59
2020,139,Suffield,5469,296,5,51,15,367,6.71
2020,140,Thomaston,3276,104,6,98,0,208,6.35
2020,141,Thompson,4171,151,13,48,0,212,5.08
2020,142,Tolland,5451,127,5,103,3,238,4.37
2020,143,Torrington,16761,908,322,547,17,1794,10.70
2020,144,Trumbull,13157,315,19,97,303,734,5.58
2020,145,Union,388,0,0,5,0,5,1.29
2020,146,Vernon,13896,1509,461,386,12,2368,17.04
2020,147,Voluntown,1127,20,1,24,0,45,3.99
2020,148,Wallingford,18945,354,129,328,35,846,4.47
2020,149,Warren,811,0,0,1,0,1,0.12
2020,150,Washington,2124,14,2,4,23,43,2.02
2020,151,Waterbury,47991,5344,3123,1751,21,10239,21.34
2020,152,Waterford,8634,123,30,266,0,419,4.85
2020,153,Watertown,9096,205,32,229,0,466,5.12
2020,155,West Hartford,26396,643,854,372,250,2119,8.03
2020,156,West Haven,22446,1024,1868,439,0,3331,14.84
2020,154,Westbrook,3937,140,5,30,29,204,5.18
2020,157,Weston,3674,0,2,6,0,8,0.22
2020,158,Westport,10399,265,60,4,58,387,3.72
2020,159,Wethersfield,11677,705,114,293,0,1112,9.52
2020,160,Willington,2637,160,5,37,0,202,7.66
2020,161,Wilton,6475,158,6,17,51,232,3.58
2020,162,Winchester,5613,350,167,92,0,609,10.85
2020,163,Windham,9570,1763,617,363,0,2743,28.66
2020,164,Windsor,11767,154,258,453,26,891,7.57
2020,165,Windsor Locks,5429,297,156,243,0,696,12.82
2020,166,Wolcott,6276,313,9,184,0,506,8.06
2020,167,Woodbridge,3478,30,8,6,0,44,1.27
2020,168,Woodbury,4564,60,3,28,0,91,1.99
2020,169,Woodstock,3582,24,0,32,0,56,1.56
2019,1,Andover,1317,18,1,29,0,48,3.64
2019,2,Ansonia,8148,349,752,140,9,1250,15.34
2019,3,Ashford,1903,32,0,35,0,67,3.52
2019,4,Avon,7389,244,13,43,0,300,4.06
2019,5,Barkhamsted,1589,0,6,20,0,26,1.64
2019,6,Beacon Falls,2509,0,3,46,0,49,1.95
2019,7,Berlin,8140,556,54,138,10,758,9.31
2019,8,Bethany,2044,0,2,12,0,14,0.68
2019,9,Bethel,7310,152,27,157,78,414,5.66
2019,10,Bethlehem,1575,24,1,9,0,34,2.16
2019,11,Bloomfield,9019,558,99,341,0,998,11.07
2019,12,Bolton,2015,0,1,28,0,29,1.44
2019,13,Bozrah,1059,0,3,30,0,33,3.12
2019,14,Branford,13972,233,60,176,0,469,3.36
2019,15,Bridgeport,57012,6395,4301,916,19,11631,20.40
2019,16,Bridgewater,881,0,0,1,0,1,0.11
2019,17,Bristol,27011,1908,884,1102,0,3894,14.42
2019,18,Brookfield,6562,155,23,111,77,366,5.58
2019,19,Brooklyn,3235,189,9,70,0,268,8.28
2019,20,Burlington,3389,27,0,44,0,71,2.10
2019,21,Canaan,779,1,4,4,1,10,1.28
2019,22,Canterbury,2043,76,1,64,0,141,6.90
2019,23,Canton,4339,211,17,49,32,309,7.12
2019,24,Chaplin,988,0,0,36,0,36,3.64
2019,25,Cheshire,10424,258,22,97,17,394,3.78
2019,26,Chester,1923,23,3,16,0,42,2.18
2019,27,Clinton,6065,105,8,58,0,171,2.82
2019,28,Colchester,6182,364,35,146,4,549,8.88
2019,29,Colebrook,722,0,1,6,1,8,1.11
2019,30,Columbia,2308,24,2,63,0,89,3.86
2019,31,Cornwall,1007,28,2,3,0,33,3.28
2019,32,Coventry,5099,103,5,133,20,261,5.12
2019,33,Cromwell,6001,212,8,197,0,417,6.95
2019,34,Danbury,31154,1590,1254,571,296,3711,11.91
2019,35,Darien,7074,136,11,2,104,253,3.58
2019,36,Deep River,2096,26,5,30,0,61,2.91
2019,37,Derby,5849,275,281,110,0,666,11.39
2019,38,Durham,2694,36,1,27,0,64,2.38
2019,40,East Granby,2152,72,1,43,0,116,5.39
2019,41,East Haddam,4508,73,5,59,0,137,3.04
2019,42,East Hampton,5485,70,5,86,25,186,3.39
2019,43,East Hartford,21328,1592,869,1030,0,3491,16.37
2019,44,East Haven,12533,542,152,313,0,1007,8.03
2019,45,East Lyme,8458,396,20,90,19,525,6.21
2019,47,East Windsor,5045,559,43,105,0,707,14.01
2019,39,Eastford,793,0,0,16,0,16,2.02
2019,46,Easton,2715,0,0,2,15,17,0.63
2019,48,Ellington,6665,260,5,107,0,372,5.58
2019,49,Enfield,17558,1340,219,652,7,2218,12.63
2019,50,Essex,3261,58,4,21,16,99,3.04
2019,51,Fairfield,21648,231,115,63,126,535,2.47
2019,52,Farmington,11106,470,107,143,155,875,7.88
2019,53,Franklin,771,27,1,16,0,44,5.71
2019,54,Glastonbury,13656,604,44,131,2,781,5.72
2019,55,Goshen,1664,1,0,4,0,5,0.30
2019,56,Granby,4360,85,1,47,5,138,3.17
2019,57,Greenwich,25631,863,459,16,33,1371,5.35
2019,58,Griswold,5118,137,53,165,0,355,6.94
2019,59,Groton,17978,3727,99,376,10,4212,23.43
2019,60,Guilford,9596,186,10,35,0,231,2.41
2019,61,Haddam,3504,22,1,27,0,50,1.43
2019,62,Hamden,25114,937,725,512,4,2178,8.67
2019,63,Hampton,793,0,1,13,0,14,1.77
2019,64,Hartford,51822,10394,8474,1514,0,20382,39.33
2019,65,Hartland,856,2,0,4,0,6,0.70
2019,66,Harwinton,2282,22,4,33,0,59,2.59
2019,67,Hebron,3567,56,3,44,0,103,2.89
2019,68,Kent,1665,58,4,5,0,67,4.02
2019,69,Killingly,7592,520,147,201,0,868,11.43
2019,70,Killingworth,2598,0,0,19,5,24,0.92
2019,71,Lebanon,3125,26,3,83,0,112,3.58
2019,72,Ledyard,5987,32,7,225,0,264,4.41
2019,73,Lisbon,1730,2,0,60,0,62,3.58
2019,74,Litchfield,3975,140,2,25,19,186,4.68
2019,75,Lyme,1223,0,0,4,8,12,0.98
2019,76,Madison,8049,90,2,11,33,136,1.69
2019,77,Manchester,25996,1851,962,964,32,3809,14.65
2019,78,Mansfield,6017,175,130,100,2,407,6.76
2019,79,Marlborough,2389,24,1,27,0,52,2.18
2019,80,Meriden,25892,1962,1249,1038,11,4260,16.45
2019,81,Middlebury,2892,77,4,26,20,127,4.39
2019,82,Middlefield,1863,30,3,19,1,53,2.84
2019,83,Middletown,21223,3019,1068,520,25,4632,21.83
2019,84,Milford,23074,726,227,199,74,1226,5.31
2019,85,Monroe,6918,32,2,54,8,96,1.39
2019,86,Montville,7407,81,54,259,0,394,5.32
2019,87,Morris,1314,20,4,7,0,31,2.36
2019,88,Naugatuck,13061,493,317,349,0,1159,8.87
2019,89,New Britain,31226,2913,1550,1151,117,5731,18.35
2019,90,New Canaan,7551,175,22,4,21,222,2.94
2019,91,New Fairfield,5593,0,4,63,17,84,1.50
2019,92,New Hartford,2923,12,7,54,15,88,3.01
2019,93,New Haven,54967,9407,6721,1009,478,17615,32.05
2019,95,New London,11840,1598,507,502,96,2703,22.83
2019,96,New Milford,11731,307,42,172,17,538,4.59
2019,94,Newington,13011,531,116,472,36,1155,8.88
2019,97,Newtown,10061,134,9,98,26,267,2.65
2019,98,Norfolk,967,21,2,4,0,27,2.79
2019,99,North Branford,5629,62,12,51,0,125,2.22
2019,100,North Canaan,1587,148,1,14,0,163,10.27
2019,101,North Haven,9491,343,57,93,23,516,5.44
2019,102,North Stonington,2306,0,0,29,6,35,1.52
2019,103,Norwalk,35415,2169,1425,427,636,4657,13.15
2019,104,Norwich,18659,2221,789,562,0,3572,19.14
2019,105,Old Lyme,5021,60,1,18,3,82,1.63
2019,106,Old Saybrook,5602,50,10,22,73,155,2.77
2019,107,Orange,5345,46,8,13,6,73,1.37
2019,108,Oxford,4746,36,4,32,0,72,1.52
2019,109,Plainfield,6229,377,173,228,0,778,12.49
2019,110,Plainville,8063,205,53,298,22,578,7.17
2019,111,Plymouth,5109,178,16,195,0,389,7.61
2019,112,Pomfret,1684,32,2,13,0,47,2.79
2019,113,Portland,4077,185,88,73,0,346,8.49
2019,114,Preston,2019,40,6,40,0,86,4.26
2019,115,Prospect,3474,0,7,52,0,59,1.70
2019,116,Putnam,4299,383,64,84,0,531,12.35
2019,117,Redding,3811,0,1,17,0,18,0.47
2019,118,Ridgefield,9420,175,6,34,69,284,3.01
2019,119,Rocky Hill,8843,235,45,195,0,475,5.37
2019,120,Roxbury,1167,19,0,5,0,24,2.06
2019,121,Salem,1635,0,2,30,0,32,1.96
2019,122,Salisbury,2593,24,2,2,14,42,1.62
2019,123,Scotland,680,0,1,25,0,26,3.82
2019,124,Seymour,6968,262,29,114,0,405,5.81
2019,125,Sharon,1775,32,1,2,0,35,1.97
2019,126,Shelton,16146,254,46,124,82,506,3.13
2019,127,Sherman,1831,0,1,7,0,8,0.44
2019,128,Simsbury,9123,289,50,93,0,432,4.74
2019,129,Somers,3479,146,7,33,0,186,5.35
2019,132,South Windsor,10243,443,52,228,9,732,7.15
2019,130,Southbury,9091,90,5,39,0,134,1.47
2019,131,Southington,17447,499,69,329,51,948,5.43
2019,133,Sprague,1248,20,13,29,1,63,5.05
2019,134,Stafford,5124,257,25,125,0,407,7.94
2019,135,Stamford,50573,4210,1913,434,1270,7827,15.48
2019,136,Sterling,1511,0,7,29,0,36,2.38
2019,137,Stonington,9467,441,24,96,0,561,5.93
2019,138,Stratford,21091,524,424,366,33,1347,6.39
2019,139,Suffield,5469,296,3,50,15,364,6.66
2019,140,Thomaston,3276,104,7,91,0,202,6.17
2019,141,Thompson,4171,151,14,51,0,216,5.18
2019,142,Tolland,5451,90,2,95,3,190,3.49
2019,143,Torrington,16761,908,406,538,17,1869,11.15
2019,144,Trumbull,13157,315,20,92,189,616,4.68
2019,145,Union,388,0,0,5,0,5,1.29
2019,146,Vernon,13896,1509,439,383,12,2343,16.86
2019,147,Voluntown,1127,20,1,27,0,48,4.26
2019,148,Wallingford,18945,354,123,309,35,821,4.33
2019,149,Warren,811,0,0,1,0,1,0.12
2019,150,Washington,2124,14,3,4,23,44,2.07
2019,151,Waterbury,47991,5344,3290,1787,21,10442,21.76
2019,152,Waterford,8634,123,35,257,0,415,4.81
2019,153,Watertown,9096,205,29,218,0,452,4.97
2019,155,West Hartford,26396,643,837,361,250,2091,7.92
2019,156,West Haven,22446,1024,1756,456,0,3236,14.42
2019,154,Westbrook,3937,140,5,28,29,202,5.13
2019,157,Weston,3674,0,2,6,0,8,0.22
2019,158,Westport,10399,265,59,3,50,377,3.63
2019,159,Wethersfield,11677,705,111,287,0,1103,9.45
2019,160,Willington,2637,160,4,35,0,199,7.55
2019,161,Wilton,6475,158,6,15,52,231,3.57
2019,162,Winchester,5613,349,168,90,0,607,10.81
2019,163,Windham,9570,1763,594,368,0,2725,28.47
2019,164,Windsor,11767,154,269,436,26,885,7.52
2019,165,Windsor Locks,5429,137,162,234,0,533,9.82
2019,166,Wolcott,6276,313,9,174,0,496,7.90
2019,167,Woodbridge,3478,30,8,5,0,43,1.24
2019,168,Woodbury,4564,60,3,29,0,92,2.02
2019,169,Woodstock,3582,24,0,33,0,57,1.59
2018,1,Andover,1317,18,2,25,0,45,3.42
2018,2,Ansonia,8148,347,747,134,9,1237,15.18
2018,3,Ashford,1903,32,0,32,0,64,3.36
2018,4,Avon,7389,244,13,34,0,291,3.94
2018,5,Barkhamsted,1589,0,6,16,0,22,1.38
2018,6,Beacon Falls,2509,0,3,40,0,43,1.71
2018,7,Berlin,8140,556,59,126,10,751,9.23
2018,8,Bethany,2044,0,2,9,1,12,0.59
2018,9,Bethel,7310,192,28,134,74,428,5.85
2018,10,Bethlehem,1575,24,0,8,0,32,2.03
2018,11,Bloomfield,9019,558,95,328,0,981,10.88
2018,12,Bolton,2015,0,1,25,0,26,1.29
2018,13,Bozrah,1059,0,4,28,0,32,3.02
2018,14,Branford,13972,233,63,152,0,448,3.21
2018,15,Bridgeport,57012,6434,4240,900,19,11593,20.33
2018,16,Bridgewater,881,0,0,1,0,1,0.11
2018,17,Bristol,27011,1766,815,1025,0,3606,13.35
2018,18,Brookfield,6562,155,24,96,77,352,5.36
2018,19,Brooklyn,3235,231,8,72,0,311,9.61
2018,20,Burlington,3389,27,0,37,0,64,1.89
2018,21,Canaan,779,35,4,5,1,45,5.78
2018,22,Canterbury,2043,76,1,56,0,133,6.51
2018,23,Canton,4339,211,14,47,32,304,7.01
2018,24,Chaplin,988,0,0,32,0,32,3.24
2018,25,Cheshire,10424,258,22,87,17,384,3.68
2018,26,Chester,1923,23,3,13,0,39,2.03
2018,27,Clinton,6065,105,12,52,0,169,2.79
2018,28,Colchester,6182,364,30,129,4,527,8.52
2018,29,Colebrook,722,0,1,5,1,7,0.97
2018,30,Columbia,2308,24,2,58,0,84,3.64
2018,31,Cornwall,1007,28,2,3,0,33,3.28
2018,32,Coventry,5099,103,4,120,20,247,4.84
2018,33,Cromwell,6001,212,9,185,0,406,6.77
2018,34,Danbury,31154,1590,943,544,296,3373,10.83
2018,35,Darien,7074,136,10,2,104,252,3.56
2018,36,Deep River,2096,26,5,29,0,60,2.86
2018,37,Derby,5849,275,302,96,0,673,11.51
2018,38,Durham,2694,36,1,17,0,54,2.00
2018,40,East Granby,2152,72,3,40,0,115,5.34
2018,41,East Haddam,4508,73,5,48,0,126,2.80
2018,42,East Hampton,5485,70,7,75,25,177,3.23
2018,43,East Hartford,21328,1574,776,989,0,3339,15.66
2018,44,East Haven,12533,542,154,302,0,998,7.96
2018,45,East Lyme,8458,396,0,82,19,497,5.88
2018,47,East Windsor,5045,559,40,102,14,715,14.17
2018,39,Eastford,793,0,0,15,0,15,1.89
2018,46,Easton,2715,0,0,1,15,16,0.59
2018,48,Ellington,6665,260,7,96,0,363,5.45
2018,49,Enfield,17558,1340,219,613,7,2179,12.41
2018,50,Essex,3261,58,5,16,16,95,2.91
2018,51,Fairfield,21648,230,105,52,140,527,2.43
2018,52,Farmington,11106,470,118,132,155,875,7.88
2018,53,Franklin,771,27,1,15,0,43,5.58
2018,54,Glastonbury,13656,582,38,117,2,739,5.41
2018,55,Goshen,1664,1,0,3,0,4,0.24
2018,56,Granby,4360,85,1,44,5,135,3.10
2018,57,Greenwich,25631,865,392,13,27,1297,5.06
2018,58,Griswold,5118,137,49,156,0,342,6.68
2018,59,Groton,17978,3587,94,358,10,4049,22.52
2018,60,Guilford,9596,186,11,32,0,229,2.39
2018,61,Haddam,3504,22,0,27,0,49,1.40
2018,62,Hamden,25114,937,699,486,4,2126,8.47
2018,63,Hampton,793,0,1,13,0,14,1.77
2018,64,Hartford,51822,10293,8267,1479,0,20039,38.67
2018,65,Hartland,856,2,0,4,0,6,0.70
2018,66,Harwinton,2282,22,4,25,0,51,2.23
2018,67,Hebron,3567,58,3,39,0,100,2.80
2018,68,Kent,1665,34,4,4,0,42,2.52
2018,69,Killingly,7592,520,112,202,0,834,10.99
2018,70,Killingworth,2598,0,0,20,5,25,0.96
2018,71,Lebanon,3125,26,4,75,0,105,3.36
2018,72,Ledyard,5987,32,9,206,0,247,4.13
2018,73,Lisbon,1730,2,0,48,0,50,2.89
2018,74,Litchfield,3975,140,4,24,19,187,4.70
2018,75,Lyme,1223,0,19,4,8,31,2.53
2018,76,Madison,8049,90,2,7,33,132,1.64
2018,77,Manchester,25996,1831,932,896,32,3691,14.20
2018,78,Mansfield,6017,175,128,99,2,404,6.71
2018,79,Marlborough,2389,24,1,26,0,51,2.13
2018,80,Meriden,25892,1887,1168,1011,11,4077,15.75
2018,81,Middlebury,2892,76,5,22,20,123,4.25
2018,82,Middlefield,1863,30,3,17,1,51,2.74
2018,83,Middletown,21223,3019,1163,484,25,4691,22.10
2018,84,Milford,23074,726,225,192,76,1219,5.28
2018,85,Monroe,6918,32,4,49,8,93,1.34
2018,86,Montville,7407,81,53,234,0,368,4.97
2018,87,Morris,1314,20,4,5,0,29,2.21
2018,88,Naugatuck,13061,493,292,328,0,1113,8.52
2018,89,New Britain,31226,2911,1477,1107,177,5672,18.16
2018,90,New Canaan,7551,215,21,3,21,260,3.44
2018,91,New Fairfield,5593,0,2,60,18,80,1.43
2018,92,New Hartford,2923,12,5,49,15,81,2.77
2018,93,New Haven,54967,9434,6600,1008,481,17523,31.88
2018,95,New London,11840,1592,483,486,99,2660,22.47
2018,96,New Milford,11731,307,35,150,17,509,4.34
2018,94,Newington,13011,530,115,435,36,1116,8.58
2018,97,Newtown,10061,134,8,88,18,248,2.46
2018,98,Norfolk,967,11,2,3,0,16,1.65
2018,99,North Branford,5629,62,14,45,4,125,2.22
2018,100,North Canaan,1587,138,1,13,0,152,9.58
2018,101,North Haven,9491,343,53,88,23,507,5.34
2018,102,North Stonington,2306,0,1,25,6,32,1.39
2018,103,Norwalk,35415,2215,1331,363,607,4516,12.75
2018,104,Norwich,18659,2221,745,528,0,3494,18.73
2018,105,Old Lyme,5021,60,2,16,3,81,1.61
2018,106,Old Saybrook,5602,50,11,19,58,138,2.46
2018,107,Orange,5345,46,9,12,6,73,1.37
2018,108,Oxford,4746,36,5,31,0,72,1.52
2018,109,Plainfield,6229,377,186,221,0,784,12.59
2018,110,Plainville,8063,205,32,277,22,536,6.65
2018,111,Plymouth,5109,178,16,170,0,364,7.12
2018,112,Pomfret,1684,32,2,13,0,47,2.79
2018,113,Portland,4077,185,85,68,0,338,8.29
2018,114,Preston,2019,40,6,39,0,85,4.21
2018,115,Prospect,3474,0,7,45,0,52,1.50
2018,116,Putnam,4299,383,62,84,0,529,12.31
2018,117,Redding,3811,0,1,13,0,14,0.37
2018,118,Ridgefield,9420,175,6,29,69,279,2.96
2018,119,Rocky Hill,8843,235,42,173,0,450,5.09
2018,120,Roxbury,1167,19,0,5,0,24,2.06
2018,121,Salem,1635,3,2,27,0,32,1.96
2018,122,Salisbury,2593,16,2,2,13,33,1.27
2018,123,Scotland,680,0,0,22,0,22,3.24
2018,124,Seymour,6968,262,34,105,0,401,5.75
2018,125,Sharon,1775,32,2,2,0,36,2.03
2018,126,Shelton,16146,254,47,120,82,503,3.12
2018,127,Sherman,1831,0,1,6,0,7,0.38
2018,128,Simsbury,9123,289,55,83,0,427,4.68
2018,129,Somers,3479,146,5,30,0,181,5.20
2018,132,South Windsor,10243,427,51,208,9,695,6.79
2018,130,Southbury,9091,89,6,34,0,129,1.42
2018,131,Southington,17447,499,71,317,51,938,5.38
2018,133,Sprague,1248,20,11,32,1,64,5.13
2018,134,Stafford,5124,257,8,119,0,384,7.49
2018,135,Stamford,50573,4112,1879,385,1272,7648,15.12
2018,136,Sterling,1511,0,6,29,0,35,2.32
2018,137,Stonington,9467,441,23,91,0,555,5.86
2018,138,Stratford,21091,524,453,333,33,1343,6.37
2018,139,Suffield,5469,248,2,48,15,313,5.72
2018,140,Thomaston,3276,104,7,80,0,191,5.83
2018,141,Thompson,4171,151,12,54,0,217,5.20
2018,142,Tolland,5451,90,3,81,3,177,3.25
2018,143,Torrington,16761,928,329,512,17,1786,10.66
2018,144,Trumbull,13157,315,19,78,180,592,4.50
2018,145,Union,388,0,0,5,0,5,1.29
2018,146,Vernon,13896,1508,401,372,12,2293,16.50
2018,147,Voluntown,1127,20,2,23,0,45,3.99
2018,148,Wallingford,18945,354,120,280,35,789,4.16
2018,149,Warren,811,0,0,0,0,0,0.00
2018,150,Washington,2124,14,3,4,23,44,2.07
2018,151,Waterbury,47991,5344,2916,1758,28,10046,20.93
2018,152,Waterford,8634,123,23,240,0,386,4.47
2018,153,Watertown,9096,205,24,196,0,425,4.67
2018,155,West Hartford,26396,587,788,332,261,1968,7.46
2018,156,West Haven,22446,1024,1499,442,0,2965,13.21
2018,154,Westbrook,3937,140,6,26,29,201,5.11
2018,157,Weston,3674,0,2,5,0,7,0.19
2018,158,Westport,10399,265,55,3,27,350,3.37
2018,159,Wethersfield,11677,705,108,264,0,1077,9.22
2018,160,Willington,2637,160,3,33,0,196,7.43
2018,161,Wilton,6475,158,5,14,82,259,4.00
2018,162,Winchester,5613,349,183,86,0,618,11.01
2018,163,Windham,9570,1763,610,360,0,2733,28.56
2018,164,Windsor,11767,154,218,408,26,806,6.85
2018,165,Windsor Locks,5429,137,138,214,0,489,9.01
2018,166,Wolcott,6276,313,8,153,0,474,7.55
2018,167,Woodbridge,3478,30,8,5,0,43,1.24
2018,168,Woodbury,4564,59,2,24,0,85,1.86
2018,169,Woodstock,3582,24,0,33,0,57,1.59
2017,1,Andover,1317,18,0,24,0,42,3.19
2017,2,Ansonia,8148,347,696,118,9,1170,14.36
2017,3,Ashford,1903,32,1,32,0,65,3.42
2017,4,Avon,7389,244,10,33,0,287,3.88
2017,5,Barkhamsted,1589,0,7,16,0,23,1.45
2017,6,Beacon Falls,2509,0,3,37,0,40,1.59
2017,7,Berlin,8140,556,53,110,10,729,8.96
2017,8,Bethany,2044,0,2,9,1,12,0.59
2017,9,Bethel,7310,152,26,117,69,364,4.98
2017,10,Bethlehem,1575,24,0,5,0,29,1.84
2017,11,Bloomfield,9019,558,88,315,0,961,10.66
2017,12,Bolton,2015,0,2,26,0,28,1.39
2017,13,Bozrah,1059,0,4,32,0,36,3.40
2017,14,Branford,13972,243,65,144,0,452,3.24
2017,15,Bridgeport,57012,6311,4259,891,19,11480,20.14
2017,16,Bridgewater,881,0,0,3,0,3,0.34
2017,17,Bristol,27011,1908,868,996,0,3772,13.96
2017,18,Brookfield,6562,155,24,81,77,337,5.14
2017,19,Brooklyn,3235,231,10,100,0,341,10.54
2017,20,Burlington,3389,27,0,36,0,63,1.86
2017,21,Canaan,779,35,4,13,1,53,6.80
2017,22,Canterbury,2043,76,1,66,0,143,7.00
2017,23,Canton,4339,211,16,50,32,309,7.12
2017,24,Chaplin,988,,0,35,0,35,3.54
2017,25,Cheshire,10424,258,20,76,17,371,3.56
2017,26,Chester,1923,23,3,14,0,40,2.08
2017,27,Clinton,6065,84,13,43,0,140,2.31
2017,28,Colchester,6182,364,37,137,0,538,8.70
2017,29,Colebrook,722,0,1,6,1,8,1.11
2017,30,Columbia,2308,40,2,60,0,102,4.42
2017,31,Cornwall,1007,28,2,4,0,34,3.38
2017,32,Coventry,5099,103,4,130,20,257,5.04
2017,33,Cromwell,6001,212,7,171,0,390,6.50
2017,34,Danbury,31154,1592,1011,497,296,3396,10.90
2017,35,Darien,7074,136,8,1,104,249,3.52
2017,36,Deep River,2096,26,6,23,0,55,2.62
2017,37,Derby,5849,274,315,88,0,677,11.57
2017,38,Durham,2694,36,0,15,0,51,1.89
2017,40,East Granby,2152,72,2,36,0,110,5.11
2017,41,East Haddam,4508,73,4,40,0,117,2.60
2017,42,East Hampton,5485,70,6,77,25,178,3.25
2017,43,East Hartford,21328,1573,851,936,0,3360,15.75
2017,44,East Haven,12533,542,139,284,0,965,7.70
2017,45,East Lyme,8458,396,18,84,19,517,6.11
2017,47,East Windsor,5045,559,38,108,14,719,14.25
2017,39,Eastford,793,0,0,16,0,16,2.02
2017,46,Easton,2715,0,0,1,16,17,0.63
2017,48,Ellington,6665,260,7,97,0,364,5.46
2017,49,Enfield,17558,1340,226,582,7,2155,12.27
2017,50,Essex,3261,58,3,13,0,74,2.27
2017,51,Fairfield,21648,218,108,49,112,487,2.25
2017,52,Farmington,11106,470,114,125,155,864,7.78
2017,53,Franklin,771,27,1,21,0,49,6.36
2017,54,Glastonbury,13656,582,42,107,2,733,5.37
2017,55,Goshen,1664,1,1,4,0,6,0.36
2017,56,Granby,4360,85,2,43,5,135,3.10
2017,57,Greenwich,25631,865,383,12,27,1287,5.02
2017,58,Griswold,5118,148,54,186,0,388,7.58
2017,59,Groton,17978,3587,108,340,10,4045,22.50
2017,60,Guilford,9596,186,8,34,0,228,2.38
2017,61,Haddam,3504,22,0,27,0,49,1.40
2017,62,Hamden,25114,937,659,456,4,2056,8.19
2017,63,Hampton,793,0,1,25,0,26,3.28
2017,64,Hartford,51822,10044,8354,1477,0,19875,38.35
2017,65,Hartland,856,2,0,3,0,5,0.58
2017,66,Harwinton,2282,22,4,29,0,55,2.41
2017,67,Hebron,3567,58,3,38,0,99,2.78
2017,68,Kent,1665,53,5,6,0,64,3.84
2017,69,Killingly,7592,520,117,296,0,933,12.29
2017,70,Killingworth,2598,0,0,23,5,28,1.08
2017,71,Lebanon,3125,26,3,85,0,114,3.65
2017,72,Ledyard,5987,32,9,204,0,245,4.09
2017,73,Lisbon,1730,2,0,55,0,57,3.29
2017,74,Litchfield,3975,140,6,26,19,191,4.81
2017,75,Lyme,1223,0,0,2,8,10,0.82
2017,76,Madison,8049,90,3,8,29,130,1.62
2017,77,Manchester,25996,1830,936,854,34,3654,14.06
2017,78,Mansfield,6017,175,133,106,2,416,6.91
2017,79,Marlborough,2389,24,2,23,0,49,2.05
2017,80,Meriden,25892,2027,1163,956,11,4157,16.06
2017,81,Middlebury,2892,76,4,22,20,122,4.22
2017,82,Middlefield,1863,30,3,14,1,48,2.58
2017,83,Middletown,21223,3019,1057,473,25,4574,21.55
2017,84,Milford,23074,726,233,188,87,1234,5.35
2017,85,Monroe,6918,32,4,43,1,80,1.16
2017,86,Montville,7407,81,50,247,0,378,5.10
2017,87,Morris,1314,20,4,5,0,29,2.21
2017,88,Naugatuck,13061,493,299,317,0,1109,8.49
2017,89,New Britain,31226,2911,1522,1074,256,5763,18.46
2017,90,New Canaan,7551,163,18,2,23,206,2.73
2017,91,New Fairfield,5593,0,4,56,18,78,1.39
2017,92,New Hartford,2923,12,7,48,15,82,2.81
2017,93,New Haven,54967,9432,6357,1019,656,17464,31.77
2017,95,New London,11840,1710,448,466,110,2734,23.09
2017,96,New Milford,11731,236,35,147,17,435,3.71
2017,94,Newington,13011,530,109,403,36,1078,8.29
2017,97,Newtown,10061,134,8,76,15,233,2.32
2017,98,Norfolk,967,28,3,5,0,36,3.72
2017,99,North Branford,5629,62,14,49,4,129,2.29
2017,100,North Canaan,1587,138,1,9,0,148,9.33
2017,101,North Haven,9491,341,56,85,0,482,5.08
2017,102,North Stonington,2306,0,1,28,6,35,1.52
2017,103,Norwalk,35415,2240,1275,335,656,4506,12.72
2017,104,Norwich,18659,2225,787,502,0,3514,18.83
2017,105,Old Lyme,5021,60,2,14,3,79,1.57
2017,106,Old Saybrook,5602,50,9,16,58,133,2.37
2017,107,Orange,5345,46,9,12,6,73,1.37
2017,108,Oxford,4746,36,5,30,0,71,1.50
2017,109,Plainfield,6229,316,186,286,0,788,12.65
2017,110,Plainville,8063,205,52,261,22,540,6.70
2017,111,Plymouth,5109,178,13,192,0,383,7.50
2017,112,Pomfret,1684,32,2,16,0,50,2.97
2017,113,Portland,4077,185,85,68,0,338,8.29
2017,114,Preston,2019,40,7,41,0,88,4.36
2017,115,Prospect,3474,0,7,44,0,51,1.47
2017,116,Putnam,4299,383,68,115,0,566,13.17
2017,117,Redding,3811,0,1,11,0,12,0.31
2017,118,Ridgefield,9420,179,5,28,64,276,2.93
2017,119,Rocky Hill,8843,235,36,159,0,430,4.86
2017,120,Roxbury,1167,19,0,3,0,22,1.89
2017,121,Salem,1635,3,2,24,0,29,1.77
2017,122,Salisbury,2593,16,2,2,13,33,1.27
2017,123,Scotland,680,0,0,21,0,21,3.09
2017,124,Seymour,6968,262,27,109,0,398,5.71
2017,125,Sharon,1775,32,2,2,0,36,2.03
2017,126,Shelton,16146,253,45,103,82,483,2.99
2017,127,Sherman,1831,0,2,8,0,10,0.55
2017,128,Simsbury,9123,289,58,76,0,423,4.64
2017,129,Somers,3479,146,4,32,0,182,5.23
2017,132,South Windsor,10243,427,50,201,0,678,6.62
2017,130,Southbury,9091,89,7,30,0,126,1.39
2017,131,Southington,17447,502,73,294,51,920,5.27
2017,133,Sprague,1248,20,15,36,1,72,5.77
2017,134,Stafford,5124,257,13,141,0,411,8.02
2017,135,Stamford,50573,4736,1864,357,1274,8231,16.28
2017,136,Sterling,1511,0,5,35,0,40,2.65
2017,137,Stonington,9467,440,22,77,0,539,5.69
2017,138,Stratford,21091,524,446,306,33,1309,6.21
2017,139,Suffield,5469,212,3,49,15,279,5.10
2017,140,Thomaston,3276,104,6,86,0,196,5.98
2017,141,Thompson,4171,151,15,75,0,241,5.78
2017,142,Tolland,5451,89,3,77,3,172,3.16
2017,143,Torrington,16761,908,395,493,17,1813,10.82
2017,144,Trumbull,13157,315,22,73,224,634,4.82
2017,145,Union,388,0,0,4,0,4,1.03
2017,146,Vernon,13896,1508,404,353,12,2277,16.39
2017,147,Voluntown,1127,20,3,26,0,49,4.35
2017,148,Wallingford,18945,354,125,269,35,783,4.13
2017,149,Warren,811,0,0,1,0,1,0.12
2017,150,Washington,2124,14,4,7,23,48,2.26
2017,151,Waterbury,47991,5272,3143,1761,172,10348,21.56
2017,152,Waterford,8634,123,19,235,0,377,4.37
2017,153,Watertown,9096,205,25,184,0,414,4.55
2017,155,West Hartford,26396,587,816,320,268,1991,7.54
2017,156,West Haven,22446,1024,1505,431,0,2960,13.19
2017,154,Westbrook,3937,140,7,22,29,198,5.03
2017,157,Weston,3674,0,1,3,0,4,0.11
2017,158,Westport,10399,293,54,4,20,371,3.57
2017,159,Wethersfield,11677,733,114,255,0,1102,9.44
2017,160,Willington,2637,160,4,35,0,199,7.55
2017,161,Wilton,6475,159,5,10,83,257,3.97
2017,162,Winchester,5613,348,206,124,0,678,12.08
2017,163,Windham,9570,1767,609,417,0,2793,29.18
2017,164,Windsor,11767,154,228,389,26,797,6.77
2017,165,Windsor Locks,5429,137,162,190,0,489,9.01
2017,166,Wolcott,6276,312,9,133,0,454,7.23
2017,167,Woodbridge,3478,30,7,5,0,42,1.21
2017,168,Woodbury,4564,59,3,24,0,86,1.88
2017,169,Woodstock,3582,24,0,48,0,72,2.01
2016,1,Andover,1317,18,0,22,0,40,3.04
2016,2,Ansonia,8148,347,658,104,9,1118,13.72
2016,3,Ashford,1903,32,2,33,0,67,3.52
2016,4,Avon,7389,244,8,31,0,283,3.83
2016,5,Barkhamsted,1589,0,7,13,0,20,1.26
2016,6,Beacon Falls,2509,0,3,34,0,37,1.47
2016,7,Berlin,8140,556,47,102,10,715,8.78
2016,8,Bethany,2044,0,2,7,1,10,0.49
2016,9,Bethel,7310,152,22,98,69,341,4.66
2016,10,Bethlehem,1575,24,0,4,0,28,1.78
2016,11,Bloomfield,9019,591,93,292,0,976,10.82
2016,12,Bolton,2015,0,2,18,0,20,0.99
2016,13,Bozrah,1059,0,3,30,0,33,3.12
2016,14,Branford,13972,243,63,145,0,451,3.23
2016,15,Bridgeport,57012,6279,4102,900,19,11300,19.82
2016,16,Bridgewater,881,0,0,4,0,4,0.45
2016,17,Bristol,27011,1916,844,931,0,3691,13.66
2016,18,Brookfield,6562,83,22,74,77,256,3.90
2016,19,Brooklyn,3235,231,12,103,0,346,10.70
2016,20,Burlington,3389,42,0,30,0,72,2.12
2016,21,Canaan,779,35,5,15,1,56,7.19
2016,22,Canterbury,2043,76,1,62,0,139,6.80
2016,23,Canton,4339,211,15,46,32,304,7.01
2016,24,Chaplin,988,0,0,33,0,33,3.34
2016,25,Cheshire,10424,259,20,69,17,365,3.50
2016,26,Chester,1923,23,3,14,0,40,2.08
2016,27,Clinton,6065,84,16,34,0,134,2.21
2016,28,Colchester,6182,364,40,120,0,524,8.48
2016,29,Colebrook,722,0,0,7,1,8,1.11
2016,30,Columbia,2308,40,2,56,0,98,4.25
2016,31,Cornwall,1007,28,2,3,0,33,3.28
2016,32,Coventry,5099,108,4,117,20,249,4.88
2016,33,Cromwell,6001,212,7,161,0,380,6.33
2016,34,Danbury,31154,1588,926,468,296,3278,10.52
2016,35,Darien,7074,136,6,1,98,241,3.41
2016,36,Deep River,2096,26,3,20,0,49,2.34
2016,37,Derby,5849,274,316,76,0,666,11.39
2016,38,Durham,2694,36,0,10,0,46,1.71
2016,40,East Granby,2152,72,0,38,0,110,5.11
2016,41,East Haddam,4508,73,3,23,0,99,2.20
2016,42,East Hampton,5485,70,6,75,25,176,3.21
2016,43,East Hartford,21328,1576,859,904,0,3339,15.66
2016,44,East Haven,12533,542,140,266,0,948,7.56
2016,45,East Lyme,8458,396,16,77,19,508,6.01
2016,47,East Windsor,5045,559,34,99,14,706,13.99
2016,39,Eastford,793,0,0,18,0,18,2.27
2016,46,Easton,2715,0,0,1,15,16,0.59
2016,48,Ellington,6665,260,5,97,0,362,5.43
2016,49,Enfield,17558,1340,217,540,7,2104,11.98
2016,50,Essex,3261,36,3,10,0,49,1.50
2016,51,Fairfield,21648,218,108,43,112,481,2.22
2016,52,Farmington,11106,470,108,118,155,851,7.66
2016,53,Franklin,771,27,0,22,0,49,6.36
2016,54,Glastonbury,13656,582,36,107,2,727,5.32
2016,55,Goshen,1664,1,1,5,0,7,0.42
2016,56,Granby,4360,85,1,41,5,132,3.03
2016,57,Greenwich,25631,856,338,11,54,1259,4.91
2016,58,Griswold,5118,148,58,174,0,380,7.42
2016,59,Groton,17978,3587,103,326,10,4026,22.39
2016,60,Guilford,9596,186,7,32,0,225,2.34
2016,61,Haddam,3504,22,0,30,0,52,1.48
2016,62,Hamden,25114,935,635,432,4,2006,7.99
2016,63,Hampton,793,0,1,27,0,28,3.53
2016,64,Hartford,51822,9972,8439,1428,0,19839,38.28
2016,65,Hartland,856,2,0,3,0,5,0.58
2016,66,Harwinton,2282,22,4,29,0,55,2.41
2016,67,Hebron,3567,58,3,33,0,94,2.64
2016,68,Kent,1665,53,5,4,0,62,3.72
2016,69,Killingly,7592,520,112,297,0,929,12.24
2016,70,Killingworth,2598,0,0,18,5,23,0.89
2016,71,Lebanon,3125,26,4,74,0,104,3.33
2016,72,Ledyard,5987,32,8,186,0,226,3.77
2016,73,Lisbon,1730,2,0,49,0,51,2.95
2016,74,Litchfield,3975,140,7,22,19,188,4.73
2016,75,Lyme,1223,0,0,2,8,10,0.82
2016,76,Madison,8049,90,3,8,29,130,1.62
2016,77,Manchester,25996,1850,890,826,34,3600,13.85
2016,78,Mansfield,6017,417,123,99,2,641,10.65
2016,79,Marlborough,2389,24,2,22,0,48,2.01
2016,80,Meriden,25892,2027,1103,936,11,4077,15.75
2016,81,Middlebury,2892,76,4,14,20,114,3.94
2016,82,Middlefield,1863,30,4,11,1,46,2.47
2016,83,Middletown,21223,3019,1035,445,25,4524,21.32
2016,84,Milford,23074,726,220,179,87,1212,5.25
2016,85,Monroe,6918,32,3,33,1,69,1.00
2016,86,Montville,7407,81,45,223,0,349,4.71
2016,87,Morris,1314,20,3,2,0,25,1.90
2016,88,Naugatuck,13061,493,270,287,0,1050,8.04
2016,89,New Britain,31226,2901,1478,1054,256,5689,18.22
2016,90,New Canaan,7551,163,13,2,23,201,2.66
2016,91,New Fairfield,5593,0,4,47,21,72,1.29
2016,92,New Hartford,2923,12,8,45,15,80,2.74
2016,93,New Haven,54967,9055,5709,1029,639,16432,29.89
2016,95,New London,11840,1713,449,449,106,2717,22.95
2016,96,New Milford,11731,268,23,129,16,436,3.72
2016,94,Newington,13011,530,108,384,36,1058,8.13
2016,97,Newtown,10061,134,6,63,15,218,2.17
2016,98,Norfolk,967,28,3,5,0,36,3.72
2016,99,North Branford,5629,62,14,46,4,126,2.24
2016,100,North Canaan,1587,138,0,8,0,146,9.20
2016,101,North Haven,9491,341,47,79,0,467,4.92
2016,102,North Stonington,2306,0,2,28,4,34,1.47
2016,103,Norwalk,35415,2224,1277,299,701,4501,12.71
2016,104,Norwich,18659,2225,784,484,0,3493,18.72
2016,105,Old Lyme,5021,60,2,8,3,73,1.45
2016,106,Old Saybrook,5602,50,9,13,20,92,1.64
2016,107,Orange,5345,46,6,13,6,71,1.33
2016,108,Oxford,4746,36,5,27,0,68,1.43
2016,109,Plainfield,6229,377,177,283,0,837,13.44
2016,110,Plainville,8063,205,48,249,22,524,6.50
2016,111,Plymouth,5109,178,11,187,0,376,7.36
2016,112,Pomfret,1684,32,2,14,0,48,2.85
2016,113,Portland,4077,185,84,66,0,335,8.22
2016,114,Preston,2019,40,8,37,0,85,4.21
2016,115,Prospect,3474,0,6,39,0,45,1.30
2016,116,Putnam,4299,383,67,112,0,562,13.07
2016,117,Redding,3811,0,0,9,0,9,0.24
2016,118,Ridgefield,9420,179,5,26,59,269,2.86
2016,119,Rocky Hill,8843,235,31,148,0,414,4.68
2016,120,Roxbury,1167,19,0,3,0,22,1.89
2016,121,Salem,1635,3,2,23,0,28,1.71
2016,122,Salisbury,2593,16,1,1,13,31,1.20
2016,123,Scotland,680,0,0,17,0,17,2.50
2016,124,Seymour,6968,262,23,97,0,382,5.48
2016,125,Sharon,1775,32,3,2,0,37,2.08
2016,126,Shelton,16146,253,38,97,82,470,2.91
2016,127,Sherman,1831,0,2,6,0,8,0.44
2016,128,Simsbury,9123,289,61,59,0,409,4.48
2016,129,Somers,3479,146,7,30,0,183,5.26
2016,132,South Windsor,10243,427,50,185,0,662,6.46
2016,130,Southbury,9091,89,7,29,0,125,1.37
2016,131,Southington,17447,502,49,266,51,868,4.98
2016,133,Sprague,1248,20,14,36,0,70,5.61
2016,134,Stafford,5124,257,13,135,0,405,7.90
2016,135,Stamford,50573,4744,1753,332,1274,8103,16.02
2016,136,Sterling,1511,0,7,33,0,40,2.65
2016,137,Stonington,9467,382,16,60,0,458,4.84
2016,138,Stratford,21091,524,421,281,33,1259,5.97
2016,139,Suffield,5469,212,2,47,15,276,5.05
2016,140,Thomaston,3276,104,6,76,0,186,5.68
2016,141,Thompson,4171,151,16,79,0,246,5.90
2016,142,Tolland,5451,89,3,66,3,161,2.95
2016,143,Torrington,16761,908,390,495,17,1810,10.80
2016,144,Trumbull,13157,315,15,58,210,598,4.55
2016,145,Union,388,0,0,4,0,4,1.03
2016,146,Vernon,13896,1440,399,329,12,2180,15.69
2016,147,Voluntown,1127,20,3,26,0,49,4.35
2016,148,Wallingford,18945,354,116,253,35,758,4.00
2016,149,Warren,811,0,0,1,0,1,0.12
2016,150,Washington,2124,14,5,10,23,52,2.45
2016,151,Waterbury,47991,5257,2969,1800,172,10198,21.25
2016,152,Waterford,8634,123,20,219,0,362,4.19
2016,153,Watertown,9096,205,23,159,0,387,4.25
2016,155,West Hartford,26396,587,786,287,268,1928,7.30
2016,156,West Haven,22446,1024,1476,411,0,2911,12.97
2016,154,Westbrook,3937,140,8,18,29,195,4.95
2016,157,Weston,3674,0,1,2,0,3,0.08
2016,158,Westport,10399,246,54,4,20,324,3.12
2016,159,Wethersfield,11677,615,99,231,0,945,8.09
2016,160,Willington,2637,160,4,33,0,197,7.47
2016,161,Wilton,6475,136,8,10,104,258,3.98
2016,162,Winchester,5613,348,187,121,0,656,11.69
2016,163,Windham,9570,1747,608,416,0,2771,28.96
2016,164,Windsor,11767,154,221,368,26,769,6.54
2016,165,Windsor Locks,5429,137,147,176,0,460,8.47
2016,166,Wolcott,6276,312,7,124,0,443,7.06
2016,167,Woodbridge,3478,30,6,5,0,41,1.18
2016,168,Woodbury,4564,59,3,22,0,84,1.84
2016,169,Woodstock,3582,24,1,49,0,74,2.07
2015,1,Andover,1317,24,0,31,0,55,4.18
2015,2,Ansonia,8148,371,654,125,9,1159,14.22
2015,3,Ashford,1903,32,2,45,0,79,4.15
2015,4,Avon,7389,244,7,32,0,283,3.83
2015,5,Barkhamsted,1589,0,5,15,0,20,1.26
2015,6,Beacon Falls,2509,0,3,38,0,41,1.63
2015,7,Berlin,8140,556,43,110,10,719,8.83
2015,8,Bethany,2044,0,1,5,1,7,0.34
2015,9,Bethel,7310,212,15,80,63,370,5.06
2015,10,Bethlehem,1575,24,0,2,0,26,1.65
2015,11,Bloomfield,9019,591,90,328,0,1009,11.19
2015,12,Bolton,2015,0,2,23,0,25,1.24
2015,12,Bolton,2015,0,3,20,0,23,1.14
2015,13,Bozrah,1059,0,2,31,0,33,3.12
2015,14,Branford,13972,231,60,193,0,484,3.46
2015,15,Bridgeport,57012,6275,3983,1062,19,11339,19.89
2015,16,Bridgewater,881,0,0,4,0,4,0.45
2015,17,Bristol,27011,1913,780,1147,0,3840,14.22
2015,18,Brookfield,6562,83,8,60,70,221,3.37
2015,19,Brooklyn,3235,231,11,116,0,358,11.07
2015,20,Burlington,3389,27,0,39,0,66,1.95
2015,21,Canaan,779,35,2,16,1,54,6.93
2015,22,Canterbury,2043,76,1,62,0,139,6.80
2015,23,Canton,4339,211,14,71,32,328,7.56
2015,24,Chaplin,988,0,0,32,0,32,3.24
2015,25,Cheshire,10424,277,16,85,17,395,3.79
2015,26,Chester,1923,23,3,14,0,40,2.08
2015,27,Clinton,6065,84,13,46,0,143,2.36
2015,28,Colchester,6182,364,34,133,0,531,8.59
2015,29,Colebrook,722,0,0,8,1,9,1.25
2015,30,Columbia,2308,40,3,61,0,104,4.51
2015,31,Cornwall,1007,28,2,4,0,34,3.38
2015,32,Coventry,5099,103,3,173,20,299,5.86
2015,33,Cromwell,6001,212,9,231,0,452,7.53
2015,34,Danbury,31154,1588,909,414,296,3207,10.29
2015,35,Darien,7074,136,6,1,95,238,3.36
2015,36,Deep River,2096,26,2,26,0,54,2.58
2015,37,Derby,5849,275,322,77,0,674,11.52
2015,38,Durham,2694,36,1,15,0,52,1.93
2015,40,East Granby,2152,72,1,40,0,113,5.25
2015,41,East Haddam,4508,73,3,38,0,114,2.53
2015,42,East Hampton,5485,70,8,100,25,203,3.70
2015,43,East Hartford,21328,1700,759,1024,0,3483,16.33
2015,44,East Haven,12533,542,139,339,0,1020,8.14
2015,45,East Lyme,8458,396,12,107,19,534,6.31
2015,47,East Windsor,5045,559,33,130,14,736,14.59
2015,39,Eastford,793,0,0,23,0,23,2.90
2015,46,Easton,2715,0,0,0,15,15,0.55
2015,48,Ellington,6665,260,5,117,0,382,5.73
2015,49,Enfield,17558,1340,199,648,7,2194,12.50
2015,50,Essex,3261,36,5,9,0,50,1.53
2015,51,Fairfield,21648,241,104,46,112,503,2.32
2015,52,Farmington,11106,496,107,143,155,901,8.11
2015,53,Franklin,771,27,0,21,0,48,6.23
2015,54,Glastonbury,13656,583,33,141,2,759,5.56
2015,55,Goshen,1664,1,1,7,0,9,0.54
2015,56,Granby,4360,85,1,51,5,142,3.26
2015,57,Greenwich,25631,969,337,3,54,1363,5.32
2015,58,Griswold,5118,148,74,209,0,431,8.42
2015,59,Groton,17978,3588,93,385,10,4076,22.67
2015,60,Guilford,9596,186,7,40,0,233,2.43
2015,61,Haddam,3504,22,0,20,0,42,1.20
2015,62,Hamden,25114,902,554,529,4,1989,7.92
2015,63,Hampton,793,0,1,36,0,37,4.67
2015,64,Hartford,51822,10697,8532,1621,0,20850,40.23
2015,65,Hartland,856,2,0,7,0,9,1.05
2015,66,Harwinton,2282,22,2,35,0,59,2.59
2015,67,Hebron,3567,58,2,44,0,104,2.92
2015,68,Kent,1665,53,4,4,0,61,3.66
2015,69,Killingly,7592,527,106,417,0,1050,13.83
2015,70,Killingworth,2598,0,0,15,5,20,0.77
2015,71,Lebanon,3125,26,4,79,0,109,3.49
2015,72,Ledyard,5987,32,6,222,0,260,4.34
2015,73,Lisbon,1730,2,0,58,0,60,3.47
2015,74,Litchfield,3975,140,5,22,29,196,4.93
2015,75,Lyme,1223,0,0,2,8,10,0.82
2015,76,Madison,8049,90,2,9,29,130,1.62
2015,77,Manchester,25996,1878,839,1013,34,3764,14.48
2015,78,Mansfield,6017,417,121,111,2,651,10.82
2015,79,Marlborough,2389,24,2,24,0,50,2.09
2015,80,Meriden,25892,2027,1102,1128,11,4268,16.48
2015,83,Middletown,21223,3142,1121,655,25,4943,23.29
2015,84,Milford,23074,726,211,242,87,1266,5.49
2015,85,Monroe,6918,32,3,29,1,65,0.94
2015,86,Montville,7407,81,37,257,0,375,5.06
2015,87,Morris,1314,20,4,1,0,25,1.90
2015,88,Naugatuck,13061,537,260,337,0,1134,8.68
2015,89,New Britain,31226,3331,1423,1271,256,6281,20.11
2015,90,New Canaan,7551,163,10,3,23,199,2.64
2015,91,New Fairfield,5593,0,1,38,13,52,0.93
2015,92,New Hartford,2923,12,6,46,15,79,2.70
2015,93,New Haven,54967,9124,5654,1240,602,16620,30.24
2015,95,New London,11840,1709,449,517,102,2777,23.45
2015,96,New Milford,11731,307,24,151,16,498,4.25
2015,94,Newington,13011,531,104,453,36,1124,8.64
2015,97,Newtown,10061,134,3,43,15,195,1.94
2015,98,Norfolk,967,28,3,6,0,37,3.83
2015,99,North Branford,5629,62,11,63,0,136,2.42
2015,100,North Canaan,1587,138,1,10,0,149,9.39
2015,101,North Haven,9491,343,40,91,0,474,4.99
2015,102,North Stonington,2306,0,2,29,0,31,1.34
2015,103,Norwalk,35415,2328,1065,304,666,4363,12.32
2015,104,Norwich,18659,2225,762,589,0,3576,19.17
2015,105,Old Lyme,5021,60,3,9,3,75,1.49
2015,106,Old Saybrook,5602,50,7,20,20,97,1.73
2015,107,Orange,5345,46,6,13,6,71,1.33
2015,108,Oxford,4746,36,4,18,0,58,1.22
2015,109,Plainfield,6229,377,180,382,0,939,15.07
2015,110,Plainville,8063,242,22,332,22,618,7.66
2015,111,Plymouth,5109,178,10,210,0,398,7.79
2015,112,Pomfret,1684,32,1,22,0,55,3.27
2015,113,Portland,4077,185,83,73,0,341,8.36
2015,114,Preston,2019,40,5,45,0,90,4.46
2015,115,Prospect,3474,0,4,38,0,42,1.21
2015,116,Putnam,4299,383,65,170,0,618,14.38
2015,117,Redding,3811,0,0,1,0,1,0.03
2015,118,Ridgefield,9420,179,3,15,59,256,2.72
2015,119,Rocky Hill,8843,235,25,194,0,454,5.13
2015,120,Roxbury,1167,19,0,2,0,21,1.80
2015,121,Salem,1635,1,0,31,0,32,1.96
2015,122,Salisbury,2593,16,2,5,12,35,1.35
2015,123,Scotland,680,0,0,17,0,17,2.50
2015,124,Seymour,6968,262,21,113,0,396,5.68
2015,125,Sharon,1775,20,2,4,0,26,1.46
2015,126,Shelton,16146,344,42,103,82,571,3.54
2015,127,Sherman,1831,0,2,4,0,6,0.33
2015,128,Simsbury,9123,241,19,79,0,339,3.72
2015,129,Somers,3479,146,10,33,0,189,5.43
2015,130,Southbury,9091,90,6,25,0,121,1.33
2015,133,Sprague,1248,20,13,39,0,72,5.77
2015,134,Stafford,5124,257,10,205,0,472,9.21
2015,135,Stamford,50573,5031,1836,361,1274,8502,16.81
2015,136,Sterling,1511,0,6,44,0,50,3.31
2015,137,Stonington,9467,383,16,72,0,471,4.98
2015,138,Stratford,21091,524,392,311,33,1260,5.97
2015,139,Suffield,5469,212,2,68,15,297,5.43
2015,140,Thomaston,3276,104,4,118,0,226,6.90
2015,141,Thompson,4171,151,11,112,0,274,6.57
2015,142,Tolland,5451,96,3,89,3,191,3.50
2015,143,Torrington,16761,1112,316,668,17,2113,12.61
2015,144,Trumbull,13157,315,16,47,210,588,4.47
2015,145,Union,388,0,0,10,0,10,2.58
2015,146,Vernon,13896,1470,371,411,12,2264,16.29
2015,147,Voluntown,1127,20,4,30,0,54,4.79
2015,148,Wallingford,18945,481,116,337,35,969,5.11
2015,149,Warren,811,0,0,5,0,5,0.62
2015,150,Washington,2124,14,5,4,23,46,2.17
2015,151,Waterbury,47991,5561,2904,2429,172,11066,23.06
2015,152,Waterford,8634,123,21,259,0,403,4.67
2015,153,Watertown,9096,205,22,167,0,394,4.33
2015,155,West Hartford,26396,621,720,357,283,1981,7.50
2015,156,West Haven,22446,1024,1438,468,0,2930,13.05
2015,154,Westbrook,3937,140,7,17,24,188,4.78
2015,157,Weston,3674,0,1,2,0,3,0.08
2015,158,Westport,10399,246,50,3,20,319,3.07
2015,159,Wethersfield,11677,615,96,278,0,989,8.47
2015,160,Willington,2637,160,1,47,0,208,7.89
2015,161,Wilton,6475,136,6,8,104,254,3.92
2015,162,Winchester,5613,348,214,161,0,723,12.88
2015,163,Windham,9570,1862,596,534,0,2992,31.26
2015,164,Windsor,11767,154,207,437,26,824,7.00
2015,165,Windsor Locks,5429,137,140,209,0,486,8.95
2015,166,Wolcott,6276,313,5,153,0,471,7.50
2015,167,Woodbridge,3478,30,5,6,0,41,1.18
2015,168,Woodbury,4564,59,3,26,0,88,1.93
2015,169,Woodstock,3582,24,2,72,0,98,2.74
2014,1,Andover,1317,24,1,32,0,57,4.33
2014,2,Ansonia,8148,371,642,112,9,1134,13.92
2014,3,Ashford,1903,32,2,50,0,84,4.41
2014,4,Avon,7389,244,8,26,0,278,3.76
2014,5,Barkhamsted,1589,0,4,13,0,17,1.07
2014,6,Beacon Falls,2509,0,2,31,0,33,1.32
2014,7,Berlin,8140,556,43,94,6,699,8.59
2014,8,Bethany,2044,0,0,2,1,3,0.15
2014,9,Bethel,7310,252,15,66,64,397,5.43
2014,10,Bethlehem,1575,24,0,1,0,25,1.59
2014,11,Bloomfield,9019,591,149,311,0,1051,11.65
2014,12,Bolton,2015,0,3,23,0,26,1.29
2014,13,Bozrah,1059,0,2,34,0,36,3.40
2014,14,Branford,13972,243,56,179,0,478,3.42
2014,15,Bridgeport,57012,5870,3779,1036,20,10705,18.78
2014,16,Bridgewater,881,0,0,2,0,2,0.23
2014,17,Bristol,27011,1633,823,1065,0,3521,13.04
2014,18,Brookfield,6562,35,7,48,70,160,2.44
2014,19,Brooklyn,3235,231,12,135,0,378,11.68
2014,20,Burlington,3389,27,0,34,0,61,1.80
2014,21,Canaan,779,25,3,30,1,59,7.57
2014,22,Canterbury,2043,76,0,79,0,155,7.59
2014,23,Canton,4339,211,17,68,32,328,7.56
2014,24,Chaplin,988,0,0,36,0,36,3.64
2014,25,Cheshire,10424,277,12,78,17,384,3.68
2014,26,Chester,1923,23,3,12,0,38,1.98
2014,27,Clinton,6065,84,9,47,0,140,2.31
2014,28,Colchester,6182,364,34,145,0,543,8.78
2014,29,Colebrook,722,0,0,10,1,11,1.52
2014,30,Columbia,2308,24,3,63,0,90,3.90
2014,31,Cornwall,1007,18,2,3,0,23,2.28
2014,32,Coventry,5099,103,1,176,20,300,5.88
2014,33,Cromwell,6001,212,13,203,0,428,7.13
2014,34,Danbury,31154,1587,904,344,296,3131,10.05
2014,35,Darien,7074,136,7,1,95,239,3.38
2014,36,Deep River,2096,26,24,26,0,76,3.63
2014,37,Derby,5849,275,314,69,0,658,11.25
2014,38,Durham,2694,36,4,14,0,54,2.00
2014,40,East Granby,2152,72,2,35,0,109,5.07
2014,41,East Haddam,4508,73,1,47,1,122,2.71
2014,42,East Hampton,5485,70,5,98,25,198,3.61
2014,43,East Hartford,21328,1700,1054,952,0,3706,17.38
2014,44,East Haven,12533,542,141,307,0,990,7.90
2014,45,East Lyme,8458,396,10,95,19,520,6.15
2014,47,East Windsor,5045,559,43,119,14,735,14.57
2014,39,Eastford,793,0,0,24,0,24,3.03
2014,46,Easton,2715,0,0,0,11,11,0.41
2014,48,Ellington,6665,260,9,106,0,375,5.63
2014,49,Enfield,17558,1340,211,581,7,2139,12.18
2014,50,Essex,3261,36,5,12,0,53,1.63
2014,51,Fairfield,21648,241,94,34,116,485,2.24
2014,52,Farmington,11106,496,110,123,155,884,7.96
2014,53,Franklin,771,27,0,16,0,43,5.58
2014,54,Glastonbury,13656,583,37,124,2,746,5.46
2014,55,Goshen,1664,1,0,9,0,10,0.60
2014,56,Granby,4360,85,1,47,5,138,3.17
2014,57,Greenwich,25631,839,334,2,54,1229,4.79
2014,58,Griswold,5118,153,67,237,0,457,8.93
2014,59,Groton,17978,3589,76,369,10,4044,22.49
2014,60,Guilford,9596,177,7,36,0,220,2.29
2014,61,Haddam,3504,22,0,25,0,47,1.34
2014,62,Hamden,25114,903,545,477,4,1929,7.68
2014,63,Hampton,793,0,2,42,0,44,5.55
2014,64,Hartford,51822,10299,7812,1523,0,19634,37.89
2014,65,Hartland,856,2,1,8,0,11,1.29
2014,66,Harwinton,2282,22,0,36,0,58,2.54
2014,67,Hebron,3567,58,3,46,0,107,3.00
2014,68,Kent,1665,52,4,4,0,60,3.60
2014,69,Killingly,7592,495,107,488,0,1090,14.36
2014,70,Killingworth,2598,0,0,11,5,16,0.62
2014,71,Lebanon,3125,26,5,88,0,119,3.81
2014,72,Ledyard,5987,32,5,204,0,241,4.03
2014,73,Lisbon,1730,2,0,57,0,59,3.41
2014,74,Litchfield,3975,140,5,28,29,202,5.08
2014,75,Lyme,1223,0,0,2,8,10,0.82
2014,76,Madison,8049,90,1,10,29,130,1.62
2014,77,Manchester,25996,1834,977,923,36,3770,14.50
2014,78,Mansfield,6017,417,125,117,2,661,10.99
2014,79,Marlborough,2389,24,2,23,0,49,2.05
2014,80,Meriden,25892,2027,1033,1065,11,4136,15.97
2014,81,Middlebury,2892,77,3,15,20,115,3.98
2014,82,Middlefield,1863,30,2,13,1,46,2.47
2014,83,Middletown,21223,2974,1047,614,25,4660,21.96
2014,84,Milford,23074,726,212,220,107,1265,5.48
2014,85,Monroe,6918,32,3,23,1,59,0.85
2014,86,Montville,7407,81,28,240,0,349,4.71
2014,87,Morris,1314,20,4,1,0,25,1.90
2014,88,Naugatuck,13061,537,368,311,0,1216,9.31
2014,89,New Britain,31226,3421,1602,1192,382,6597,21.13
2014,90,New Canaan,7551,163,9,2,31,205,2.71
2014,91,New Fairfield,5593,0,0,27,13,40,0.72
2014,92,New Hartford,2923,12,5,46,15,78,2.67
2014,93,New Haven,54967,8880,5336,1188,581,15985,29.08
2014,95,New London,11840,1685,674,487,98,2944,24.86
2014,96,New Milford,11731,269,27,147,16,459,3.91
2014,94,Newington,13011,537,148,390,36,1111,8.54
2014,97,Newtown,10061,134,3,29,15,181,1.80
2014,98,Norfolk,967,28,2,9,0,39,4.03
2014,99,North Branford,5629,62,10,62,0,134,2.38
2014,100,North Canaan,1587,138,1,8,0,147,9.26
2014,101,North Haven,9491,343,36,76,1,456,4.80
2014,102,North Stonington,2306,0,2,22,0,24,1.04
2014,103,Norwalk,35415,2334,997,261,599,4191,11.83
2014,104,Norwich,18659,2109,721,554,0,3384,18.14
2014,105,Old Lyme,5021,64,2,9,3,78,1.55
2014,106,Old Saybrook,5602,50,7,19,20,96,1.71
2014,107,Orange,5345,46,6,10,6,68,1.27
2014,108,Oxford,4746,36,3,12,0,51,1.07
2014,109,Plainfield,6229,377,166,460,0,1003,16.10
2014,110,Plainville,8063,242,21,311,22,596,7.39
2014,111,Plymouth,5109,178,18,224,0,420,8.22
2014,112,Pomfret,1684,32,1,28,0,61,3.62
2014,113,Portland,4077,185,82,64,0,331,8.12
2014,114,Preston,2019,40,5,44,0,89,4.41
2014,115,Prospect,3474,0,4,38,0,42,1.21
2014,116,Putnam,4299,383,69,208,0,660,15.35
2014,117,Redding,3811,0,0,0,0,0,0.00
2014,118,Ridgefield,9420,179,1,9,48,237,2.52
2014,119,Rocky Hill,8843,235,30,179,0,444,5.02
2014,120,Roxbury,1167,19,0,1,0,20,1.71
2014,121,Salem,1635,1,0,34,0,35,2.14
2014,122,Salisbury,2593,16,2,7,12,37,1.43
2014,123,Scotland,680,0,0,13,0,13,1.91
2014,124,Seymour,6968,262,18,97,0,377,5.41
2014,125,Sharon,1775,20,2,4,0,26,1.46
2014,126,Shelton,16146,344,34,87,82,547,3.39
2014,127,Sherman,1831,0,2,3,0,5,0.27
2014,128,Simsbury,9123,241,19,62,0,322,3.53
2014,129,Somers,3479,146,12,31,0,189,5.43
2014,132,South Windsor,10243,427,49,239,0,715,6.98
2014,130,Southbury,9091,90,4,18,0,112,1.23
2014,131,Southington,17447,609,67,295,51,1022,5.86
2014,133,Sprague,1248,20,13,47,0,80,6.41
2014,134,Stafford,5124,178,13,231,0,422,8.24
2014,135,Stamford,50573,4862,1732,326,1295,8215,16.24
2014,136,Sterling,1511,0,6,61,0,67,4.43
2014,137,Stonington,9467,297,15,71,0,383,4.05
2014,138,Stratford,21091,524,381,278,33,1216,5.77
2014,139,Suffield,5469,212,3,64,15,294,5.38
2014,140,Thomaston,3276,104,4,115,0,223,6.81
2014,141,Thompson,4171,151,25,133,0,309,7.41
2014,142,Tolland,5451,98,2,93,3,196,3.60
2014,143,Torrington,16761,1112,277,639,17,2045,12.20
2014,144,Trumbull,13157,315,15,36,317,683,5.19
2014,145,Union,388,0,0,12,0,12,3.09
2014,146,Vernon,13896,1387,391,374,12,2164,15.57
2014,147,Voluntown,1127,20,4,38,0,62,5.50
2014,148,Wallingford,18945,481,115,310,35,941,4.97
2014,149,Warren,811,0,0,5,0,5,0.62
2014,150,Washington,2124,14,6,7,23,50,2.35
2014,151,Waterbury,47991,5171,3074,2327,326,10898,22.71
2014,152,Waterford,8634,123,20,239,0,382,4.42
2014,153,Watertown,9096,205,18,145,0,368,4.05
2014,155,West Hartford,26396,621,832,316,287,2056,7.79
2014,156,West Haven,22446,1024,1451,429,0,2904,12.94
2014,154,Westbrook,3937,140,7,17,24,188,4.78
2014,157,Weston,3674,0,1,0,0,1,0.03
2014,158,Westport,10399,246,45,2,20,313,3.01
2014,159,Wethersfield,11677,615,134,231,0,980,8.39
2014,160,Willington,2637,160,1,46,0,207,7.85
2014,161,Wilton,6475,136,7,7,100,250,3.86
2014,162,Winchester,5613,348,444,187,0,979,17.44
2014,163,Windham,9570,1862,541,575,0,2978,31.12
2014,164,Windsor,11767,154,297,401,26,878,7.46
2014,165,Windsor Locks,5429,137,153,187,0,477,8.79
2014,166,Wolcott,6276,313,4,131,0,448,7.14
2014,167,Woodbridge,3478,30,5,6,0,41,1.18
2014,168,Woodbury,4564,59,2,25,0,86,1.88
2014,169,Woodstock,3582,24,3,72,0,99,2.76
2013,1,Andover,1317,24,1,29,0,54,4.10
2013,2,Ansonia,8148,371,756,112,9,1248,15.32
2013,3,Ashford,1903,32,2,48,0,82,4.31
2013,4,Avon,7389,244,7,29,0,280,3.79
2013,5,Barkhamsted,1589,0,1,15,0,16,1.01
2013,6,Beacon Falls,2509,0,5,32,0,37,1.47
2013,7,Berlin,8140,556,29,93,6,684,8.40
2013,8,Bethany,2044,0,0,2,1,3,0.15
2013,9,Bethel,7310,252,10,64,63,389,5.32
2013,10,Bethlehem,1575,24,1,1,0,26,1.65
2013,11,Bloomfield,9019,592,147,306,0,1045,11.59
2013,12,Bolton,2015,0,3,20,0,23,1.14
2013,13,Bozrah,1059,0,4,29,0,33,3.12
2013,14,Branford,13972,243,50,179,0,472,3.38
2013,15,Bridgeport,57012,5738,3781,1014,20,10553,18.51
2013,16,Bridgewater,881,0,0,2,0,2,0.23
2013,17,Bristol,27011,1771,798,1065,0,3634,13.45
2013,18,Brookfield,6562,35,7,55,63,160,2.44
2013,19,Brooklyn,3235,232,11,135,0,378,11.68
2013,20,Burlington,3389,28,0,41,0,69,2.04
2013,21,Canaan,779,25,0,10,1,36,4.62
2013,22,Canterbury,2043,76,1,69,0,146,7.15
2013,23,Canton,4339,211,19,63,32,325,7.49
2013,24,Chaplin,988,0,0,28,0,28,2.83
2013,25,Cheshire,10424,237,7,76,17,337,3.23
2013,26,Chester,1923,23,2,13,0,38,1.98
2013,27,Clinton,6065,84,5,48,0,137,2.26
2013,28,Colchester,6182,364,31,125,0,520,8.41
2013,29,Colebrook,722,0,0,8,1,9,1.25
2013,30,Columbia,2308,24,2,60,0,86,3.73
2013,31,Cornwall,1007,18,0,6,0,24,2.38
2013,32,Coventry,5099,104,1,182,20,307,6.02
2013,33,Cromwell,6001,212,6,200,0,418,6.97
2013,34,Danbury,31154,1586,1180,344,295,3405,10.93
2013,35,Darien,7074,83,6,1,95,185,2.62
2013,36,Deep River,2096,26,5,27,0,58,2.77
2013,37,Derby,5849,259,307,68,0,634,10.84
2013,38,Durham,2694,34,1,21,0,56,2.08
2013,40,East Granby,2152,72,4,37,0,113,5.25
2013,41,East Haddam,4508,73,0,42,1,116,2.57
2013,42,East Hampton,5485,70,5,100,25,200,3.65
2013,43,East Hartford,21328,1578,1024,950,0,3552,16.65
2013,44,East Haven,12533,422,128,307,0,857,6.84
2013,45,East Lyme,8458,344,8,102,19,473,5.59
2013,47,East Windsor,5045,558,49,127,14,748,14.83
2013,39,Eastford,793,0,0,25,0,25,3.15
2013,46,Easton,2715,0,0,0,11,11,0.41
2013,48,Ellington,6665,260,8,125,0,393,5.90
2013,49,Enfield,17558,1340,215,581,7,2143,12.21
2013,50,Essex,3261,36,6,13,0,55,1.69
2013,51,Fairfield,21648,241,181,34,116,572,2.64
2013,52,Farmington,11106,469,110,124,155,858,7.73
2013,53,Franklin,771,0,1,20,0,21,2.72
2013,54,Glastonbury,13656,582,47,124,2,755,5.53
2013,55,Goshen,1664,1,0,7,0,8,0.48
2013,56,Granby,4360,85,2,60,5,152,3.49
2013,57,Greenwich,25631,837,421,2,54,1314,5.13
2013,58,Griswold,5118,153,41,222,0,416,8.13
2013,59,Groton,17978,3267,52,361,10,3690,20.53
2013,60,Guilford,9596,168,6,42,0,216,2.25
2013,61,Haddam,3504,22,1,21,0,44,1.26
2013,62,Hamden,25114,685,523,477,4,1689,6.73
2013,63,Hampton,793,0,0,32,0,32,4.04
2013,64,Hartford,51822,9540,8525,1523,0,19588,37.80
2013,65,Hartland,856,2,0,10,0,12,1.40
2013,66,Harwinton,2282,22,0,35,0,57,2.50
2013,67,Hebron,3567,59,3,46,0,108,3.03
2013,68,Kent,1665,24,0,4,0,28,1.68
2013,69,Killingly,7592,530,125,479,0,1134,14.94
2013,70,Killingworth,2598,0,2,10,5,17,0.65
2013,71,Lebanon,3125,26,4,79,0,109,3.49
2013,72,Ledyard,5987,32,6,226,0,264,4.41
2013,73,Lisbon,1730,2,0,64,0,66,3.82
2013,74,Litchfield,3975,140,1,16,29,186,4.68
2013,75,Lyme,1223,0,0,2,8,10,0.82
2013,76,Madison,8049,90,1,10,29,130,1.62
2013,77,Manchester,25996,1833,1074,925,36,3868,14.88
2013,78,Mansfield,6017,417,153,108,2,680,11.30
2013,79,Marlborough,2389,24,0,29,0,53,2.22
2013,80,Meriden,25892,1745,1012,1065,11,3833,14.80
2013,81,Middlebury,2892,76,4,20,8,108,3.73
2013,82,Middlefield,1863,30,1,12,1,44,2.36
2013,83,Middletown,21223,2859,1467,614,25,4965,23.39
2013,84,Milford,23074,822,277,220,107,1426,6.18
2013,85,Monroe,6918,32,1,25,1,59,0.85
2013,86,Montville,7407,81,30,262,0,373,5.04
2013,87,Morris,1314,20,2,1,0,23,1.75
2013,88,Naugatuck,13061,493,293,311,0,1097,8.40
2013,89,New Britain,31226,3266,1627,1192,382,6467,20.71
2013,90,New Canaan,7551,162,10,2,31,205,2.71
2013,91,New Fairfield,5593,0,0,36,13,49,0.88
2013,92,New Hartford,2923,12,1,42,15,70,2.39
2013,93,New Haven,54967,8261,6232,1188,605,16286,29.63
2013,95,New London,11840,1672,144,482,83,2381,20.11
2013,96,New Milford,11731,233,259,172,16,680,5.80
2013,94,Newington,13011,425,105,390,36,956,7.35
2013,97,Newtown,10061,134,2,35,15,186,1.85
2013,98,Norfolk,967,28,0,3,0,31,3.21
2013,99,North Branford,5629,62,7,62,0,131,2.33
2013,100,North Canaan,1587,101,0,8,0,109,6.87
2013,101,North Haven,9491,343,28,76,1,448,4.72
2013,102,North Stonington,2306,0,1,28,0,29,1.26
2013,103,Norwalk,35415,2299,957,261,599,4116,11.62
2013,104,Norwich,18659,1972,728,550,0,3250,17.42
2013,105,Old Lyme,5021,60,1,11,3,75,1.49
2013,106,Old Saybrook,5602,50,5,18,19,92,1.64
2013,107,Orange,5345,46,4,10,6,66,1.23
2013,108,Oxford,4746,36,1,14,0,51,1.07
2013,109,Plainfield,6229,378,224,386,0,988,15.86
2013,110,Plainville,8063,242,25,311,22,600,7.44
2013,111,Plymouth,5109,179,5,179,0,363,7.11
2013,112,Pomfret,1684,32,2,28,0,62,3.68
2013,113,Portland,4077,185,92,62,0,339,8.31
2013,114,Preston,2019,40,4,47,0,91,4.51
2013,115,Prospect,3474,0,4,34,0,38,1.09
2013,116,Putnam,4299,383,79,200,0,662,15.40
2013,117,Redding,3811,0,0,0,0,0,0.00
2013,118,Ridgefield,9420,179,0,9,42,230,2.44
2013,119,Rocky Hill,8843,236,29,179,0,444,5.02
2013,120,Roxbury,1167,19,0,2,0,21,1.80
2013,121,Salem,1635,1,0,34,0,35,2.14
2013,122,Salisbury,2593,16,1,7,10,34,1.31
2013,123,Scotland,680,0,0,16,0,16,2.35
2013,124,Seymour,6968,262,16,103,0,381,5.47
2013,125,Sharon,1775,20,0,4,0,24,1.35
2013,126,Shelton,16146,254,21,87,82,444,2.75
2013,127,Sherman,1831,0,1,3,0,4,0.22
2013,128,Simsbury,9123,241,11,62,0,314,3.44
2013,129,Somers,3479,146,7,29,0,182,5.23
2013,132,South Windsor,10243,427,54,239,0,720,7.03
2013,130,Southbury,9091,89,2,23,0,114,1.25
2013,131,Southington,17447,609,42,295,51,997,5.71
2013,133,Sprague,1248,20,9,35,0,64,5.13
2013,134,Stafford,5124,178,11,198,0,387,7.55
2013,135,Stamford,50573,4863,1631,326,1295,8115,16.05
2013,136,Sterling,1511,0,1,61,0,62,4.10
2013,137,Stonington,9467,296,17,66,0,379,4.00
2013,138,Stratford,21091,524,375,278,33,1210,5.74
2013,139,Suffield,5469,212,0,70,15,297,5.43
2013,140,Thomaston,3276,105,4,117,0,226,6.90
2013,141,Thompson,4171,151,13,159,0,323,7.74
2013,142,Tolland,5451,97,1,110,3,211,3.87
2013,143,Torrington,16761,1112,355,639,17,2123,12.67
2013,144,Trumbull,13157,315,12,36,314,677,5.15
2013,145,Union,388,0,0,16,0,16,4.12
2013,146,Vernon,13896,1387,533,374,12,2306,16.59
2013,147,Voluntown,1127,20,2,31,0,53,4.70
2013,148,Wallingford,18945,482,140,310,35,967,5.10
2013,149,Warren,811,0,0,8,0,8,0.99
2013,150,Washington,2124,14,0,1,23,38,1.79
2013,151,Waterbury,47991,4901,3635,2327,326,11189,23.31
2013,152,Waterford,8634,123,17,250,0,390,4.52
2013,153,Watertown,9096,206,24,145,0,375,4.12
2013,155,West Hartford,26396,590,943,316,287,2136,8.09
2013,156,West Haven,22446,1024,1613,429,0,3066,13.66
2013,154,Westbrook,3937,140,8,15,24,187,4.75
2013,157,Weston,3674,0,1,0,0,1,0.03
2013,158,Westport,10399,245,20,2,19,286,2.75
2013,159,Wethersfield,11677,625,127,231,0,983,8.42
2013,160,Willington,2637,160,2,50,0,212,8.04
2013,161,Wilton,6475,135,5,7,100,247,3.81
2013,162,Winchester,5613,316,269,150,0,735,13.09
2013,163,Windham,9570,1752,533,490,0,2775,29.00
2013,164,Windsor,11767,154,282,399,26,861,7.32
2013,165,Windsor Locks,5429,137,178,187,0,502,9.25
2013,166,Wolcott,6276,312,3,131,0,446,7.11
2013,167,Woodbridge,3478,30,3,6,0,39,1.12
2013,168,Woodbury,4564,60,4,25,0,89,1.95
2013,169,Woodstock,3582,24,3,87,0,114,3.18
2012,1,Andover,1317,24,1,22,0,47,3.57
2012,2,Ansonia,8148,372,699,106,9,1186,14.56
2012,3,Ashford,1903,32,2,37,0,71,3.73
2012,4,Avon,7389,240,7,23,0,270,3.65
2012,5,Barkhamsted,1589,0,1,12,0,13,0.82
2012,6,Beacon Falls,2509,0,5,26,0,31,1.24
2012,7,Berlin,8140,468,29,82,6,585,7.19
2012,8,Bethany,2044,0,0,1,1,2,0.10
2012,9,Bethel,7310,250,10,57,63,380,5.20
2012,10,Bethlehem,1575,24,1,0,0,25,1.59
2012,11,Bloomfield,9019,584,147,295,0,1026,11.38
2012,12,Bolton,2015,0,3,16,0,19,0.94
2012,13,Bozrah,1059,0,4,19,0,23,2.17
2012,14,Branford,13972,232,50,174,0,456,3.26
2012,15,Bridgeport,57012,5604,3498,964,20,10086,17.69
2012,16,Bridgewater,881,0,0,2,0,2,0.23
2012,17,Bristol,27011,1771,793,1014,0,3578,13.25
2012,18,Brookfield,6562,35,7,42,55,139,2.12
2012,19,Brooklyn,3235,233,11,80,0,324,10.02
2012,20,Burlington,3389,28,0,29,0,57,1.68
2012,21,Canaan,779,25,0,9,1,35,4.49
2012,22,Canterbury,2043,76,1,40,0,117,5.73
2012,23,Canton,4339,211,19,55,32,317,7.31
2012,24,Chaplin,988,0,0,24,0,24,2.43
2012,25,Cheshire,10424,237,7,70,17,331,3.18
2012,26,Chester,1923,23,2,10,0,35,1.82
2012,27,Clinton,6065,84,5,43,0,132,2.18
2012,28,Colchester,6182,364,31,93,0,488,7.89
2012,29,Colebrook,722,0,0,7,1,8,1.11
2012,30,Columbia,2308,24,2,43,0,69,2.99
2012,31,Cornwall,1007,18,0,2,0,20,1.99
2012,32,Coventry,5099,104,1,136,20,261,5.12
2012,33,Cromwell,6001,212,6,199,0,417,6.95
2012,34,Danbury,31154,1586,1181,315,192,3274,10.51
2012,35,Darien,7074,83,6,1,93,183,2.59
2012,36,Deep River,2096,26,5,23,0,54,2.58
2012,37,Derby,5849,259,307,63,0,629,10.75
2012,38,Durham,2694,33,1,13,0,47,1.74
2012,40,East Granby,2152,72,4,32,0,108,5.02
2012,41,East Haddam,4508,73,0,30,1,104,2.31
2012,42,East Hampton,5485,70,5,76,25,176,3.21
2012,43,East Hartford,21328,1577,1024,908,0,3509,16.45
2012,44,East Haven,12533,421,128,294,0,843,6.73
2012,45,East Lyme,8458,342,8,80,19,449,5.31
2012,47,East Windsor,5045,558,49,100,14,721,14.29
2012,39,Eastford,793,0,0,19,0,19,2.40
2012,46,Easton,2715,0,0,0,11,11,0.41
2012,48,Ellington,6665,260,8,83,0,351,5.27
2012,49,Enfield,17558,1340,215,546,7,2108,12.01
2012,50,Essex,3261,36,6,9,0,51,1.56
2012,51,Fairfield,21648,241,181,29,116,567,2.62
2012,52,Farmington,11106,456,110,117,155,838,7.55
2012,53,Franklin,771,0,1,16,0,17,2.20
2012,54,Glastonbury,13656,582,47,122,2,753,5.51
2012,55,Goshen,1664,1,0,5,0,6,0.36
2012,56,Granby,4360,85,2,42,5,134,3.07
2012,57,Greenwich,25631,837,421,2,54,1314,5.13
2012,58,Griswold,5118,136,41,159,0,336,6.57
2012,59,Groton,17978,3267,52,337,10,3666,20.39
2012,60,Guilford,9596,168,6,29,0,203,2.12
2012,61,Haddam,3504,22,1,15,0,38,1.08
2012,62,Hamden,25114,684,523,448,4,1659,6.61
2012,63,Hampton,793,0,0,18,0,18,2.27
2012,64,Hartford,51822,9415,8390,1440,0,19245,37.14
2012,65,Hartland,856,2,0,6,0,8,0.93
2012,66,Harwinton,2282,23,0,25,0,48,2.10
2012,67,Hebron,3567,59,3,36,0,98,2.75
2012,68,Kent,1665,48,0,4,0,52,3.12
2012,69,Killingly,7592,530,120,309,0,959,12.63
2012,70,Killingworth,2598,0,2,5,5,12,0.46
2012,71,Lebanon,3125,26,4,56,0,86,2.75
2012,72,Ledyard,5987,32,6,168,0,206,3.44
2012,73,Lisbon,1730,2,0,43,0,45,2.60
2012,74,Litchfield,3975,140,1,12,29,182,4.58
2012,75,Lyme,1223,0,0,2,8,10,0.82
2012,76,Madison,8049,90,1,8,29,128,1.59
2012,77,Manchester,25996,1813,1074,884,36,3807,14.64
2012,78,Mansfield,6017,417,153,86,2,658,10.94
2012,79,Marlborough,2389,24,0,20,0,44,1.84
2012,80,Meriden,25892,1769,1008,1022,11,3810,14.71
2012,81,Middlebury,2892,76,4,12,8,100,3.46
2012,82,Middlefield,1863,30,1,10,1,42,2.25
2012,83,Middletown,21223,2814,987,590,25,4416,20.81
2012,84,Milford,23074,822,277,212,85,1396,6.05
2012,85,Monroe,6918,35,1,19,1,56,0.81
2012,86,Montville,7407,81,30,201,0,312,4.21
2012,87,Morris,1314,20,2,0,0,22,1.67
2012,88,Naugatuck,13061,492,293,301,0,1086,8.31
2012,89,New Britain,31226,3183,1627,1153,382,6345,20.32
2012,90,New Canaan,7551,140,10,2,31,183,2.42
2012,91,New Fairfield,5593,0,0,25,13,38,0.68
2012,92,New Hartford,2923,12,1,38,15,66,2.26
2012,93,New Haven,54967,8210,6138,1127,545,16020,29.14
2012,95,New London,11840,1672,144,457,83,2356,19.90
2012,96,New Milford,11731,233,259,123,16,631,5.38
2012,94,Newington,13011,426,105,366,36,933,7.17
2012,97,Newtown,10061,134,2,23,15,174,1.73
2012,98,Norfolk,967,28,0,3,0,31,3.21
2012,99,North Branford,5629,62,7,55,0,124,2.20
2012,100,North Canaan,1587,101,0,7,0,108,6.81
2012,101,North Haven,9491,343,28,74,1,446,4.70
2012,102,North Stonington,2306,0,1,21,0,22,0.95
2012,103,Norwalk,35415,2248,947,238,616,4049,11.43
2012,104,Norwich,18659,1906,728,518,0,3152,16.89
2012,105,Old Lyme,5021,60,1,7,3,71,1.41
2012,106,Old Saybrook,5602,50,5,16,1,72,1.29
2012,107,Orange,5345,46,4,9,0,59,1.10
2012,108,Oxford,4746,36,1,8,0,45,0.95
2012,109,Plainfield,6229,378,224,296,0,898,14.42
2012,110,Plainville,8063,223,25,302,21,571,7.08
2012,111,Plymouth,5109,179,5,152,0,336,6.58
2012,112,Pomfret,1684,32,2,17,0,51,3.03
2012,113,Portland,4077,185,92,51,0,328,8.05
2012,114,Preston,2019,40,4,36,0,80,3.96
2012,115,Prospect,3474,0,4,25,0,29,0.83
2012,116,Putnam,4299,383,73,133,0,589,13.70
2012,117,Redding,3811,0,0,0,0,0,0.00
2012,118,Ridgefield,9420,179,0,8,33,220,2.34
2012,119,Rocky Hill,8843,236,29,173,0,438,4.95
2012,120,Roxbury,1167,19,0,1,0,20,1.71
2012,121,Salem,1635,1,0,28,0,29,1.77
2012,122,Salisbury,2593,16,1,5,10,32,1.23
2012,123,Scotland,680,0,0,11,0,11,1.62
2012,124,Seymour,6968,262,16,89,0,367,5.27
2012,125,Sharon,1775,20,0,4,0,24,1.35
2012,126,Shelton,16146,254,21,83,82,440,2.73
2012,127,Sherman,1831,0,1,1,0,2,0.11
2012,128,Simsbury,9123,241,11,58,0,310,3.40
2012,129,Somers,3479,54,7,18,0,79,2.27
2012,132,South Windsor,10243,427,54,235,0,716,6.99
2012,130,Southbury,9091,89,2,14,0,105,1.15
2012,131,Southington,17447,609,42,281,51,983,5.63
2012,133,Sprague,1248,20,9,31,0,60,4.81
2012,134,Stafford,5124,178,11,160,0,349,6.81
2012,135,Stamford,50573,4618,1605,309,1295,7827,15.48
2012,136,Sterling,1511,0,1,35,0,36,2.38
2012,137,Stonington,9467,296,17,52,0,365,3.86
2012,138,Stratford,21091,524,375,259,33,1191,5.65
2012,139,Suffield,5469,212,0,52,15,279,5.10
2012,140,Thomaston,3276,105,4,91,0,200,6.11
2012,141,Thompson,4171,150,13,83,0,246,5.90
2012,142,Tolland,5451,97,1,79,3,180,3.30
2012,143,Torrington,16761,1082,297,611,17,2007,11.97
2012,144,Trumbull,13157,315,12,35,314,676,5.14
2012,145,Union,388,0,0,9,0,9,2.32
2012,146,Vernon,13896,1386,533,352,12,2283,16.43
2012,147,Voluntown,1127,20,2,23,0,45,3.99
2012,148,Wallingford,18945,482,140,298,35,955,5.04
2012,149,Warren,811,0,0,4,0,4,0.49
2012,150,Washington,2124,14,0,0,23,37,1.74
2012,151,Waterbury,47991,4870,3149,2256,326,10601,22.09
2012,152,Waterford,8634,123,17,208,0,348,4.03
2012,153,Watertown,9096,206,24,134,0,364,4.00
2012,155,West Hartford,26396,541,943,304,287,2075,7.86
2012,156,West Haven,22446,1024,1503,415,0,2942,13.11
2012,154,Westbrook,3937,140,8,13,24,185,4.70
2012,157,Weston,3674,0,1,0,0,1,0.03
2012,158,Westport,10399,245,20,2,15,282,2.71
2012,159,Wethersfield,11677,625,127,216,0,968,8.29
2012,160,Willington,2637,160,2,37,0,199,7.55
2012,161,Wilton,6475,84,5,7,140,236,3.64
2012,162,Winchester,5613,316,269,122,0,707,12.60
2012,163,Windham,9570,1692,436,448,0,2576,26.92
2012,164,Windsor,11767,154,282,379,26,841,7.15
2012,165,Windsor Locks,5429,137,178,182,0,497,9.15
2012,166,Wolcott,6276,312,3,121,0,436,6.95
2012,167,Woodbridge,3478,30,3,6,0,39,1.12
2012,168,Woodbury,4564,60,4,19,0,83,1.82
2012,169,Woodstock,3582,24,3,52,0,79,2.21
2011,1,Andover,1317,24,1,20,0,45,3.42
2011,2,Ansonia,8148,372,699,106,9,1186,14.56
2011,3,Ashford,1903,32,1,35,0,68,3.57
2011,4,Avon,7389,240,5,21,0,266,3.60
2011,5,Barkhamsted,1589,0,3,11,0,14,0.88
2011,6,Beacon Falls,2509,0,6,25,0,31,1.24
2011,7,Berlin,8140,468,30,82,6,586,7.20
2011,8,Bethany,2044,0,0,1,0,1,0.05
2011,9,Bethel,7310,250,9,57,63,379,5.18
2011,10,Bethlehem,1575,24,0,0,0,24,1.52
2011,11,Bloomfield,9019,584,147,295,0,1026,11.38
2011,12,Bolton,2015,0,3,15,0,18,0.89
2011,13,Bozrah,1059,0,4,16,0,20,1.89
2011,14,Branford,13972,232,46,174,0,452,3.24
2011,15,Bridgeport,57012,5604,3724,964,15,10307,18.08
2011,16,Bridgewater,881,0,0,2,0,2,0.23
2011,17,Bristol,27011,1771,791,1014,0,3576,13.24
2011,18,Brookfield,6562,35,6,38,52,131,2.00
2011,19,Brooklyn,3235,233,9,63,0,305,9.43
2011,20,Burlington,3389,28,0,25,0,53,1.56
2011,21,Canaan,779,25,0,9,1,35,4.49
2011,22,Canterbury,2043,76,1,31,0,108,5.29
2011,23,Canton,4339,211,20,52,32,315,7.26
2011,24,Chaplin,988,0,1,23,0,24,2.43
2011,25,Cheshire,10424,237,5,70,17,329,3.16
2011,26,Chester,1923,23,2,9,0,34,1.77
2011,27,Clinton,6065,84,5,42,0,131,2.16
2011,28,Colchester,6182,364,26,84,0,474,7.67
2011,29,Colebrook,722,0,0,7,1,8,1.11
2011,30,Columbia,2308,24,4,37,0,65,2.82
2011,31,Cornwall,1007,18,0,0,0,18,1.79
2011,32,Coventry,5099,104,5,116,20,245,4.80
2011,33,Cromwell,6001,212,6,199,0,417,6.95
2011,34,Danbury,31154,1586,952,315,273,3126,10.03
2011,35,Darien,7074,83,8,1,93,185,2.62
2011,36,Deep River,2096,26,4,22,0,52,2.48
2011,37,Derby,5849,259,305,63,0,627,10.72
2011,38,Durham,2694,33,1,11,0,45,1.67
2011,40,East Granby,2152,72,1,30,0,103,4.79
2011,41,East Haddam,4508,73,3,27,1,104,2.31
2011,42,East Hampton,5485,70,1,69,25,165,3.01
2011,43,East Hartford,21328,1577,835,908,0,3320,15.57
2011,44,East Haven,12533,421,254,294,0,969,7.73
2011,45,East Lyme,8458,342,61,78,10,491,5.81
2011,47,East Windsor,5045,558,27,92,14,691,13.70
2011,39,Eastford,793,0,0,16,0,16,2.02
2011,46,Easton,2715,0,33,0,11,44,1.62
2011,48,Ellington,6665,260,6,69,0,335,5.03
2011,49,Enfield,17558,1340,215,546,7,2108,12.01
2011,50,Essex,3261,36,4,8,0,48,1.47
2011,51,Fairfield,21648,241,182,29,117,569,2.63
2011,52,Farmington,11106,456,110,117,154,837,7.54
2011,53,Franklin,771,0,1,15,0,16,2.08
2011,54,Glastonbury,13656,582,49,122,0,753,5.51
2011,55,Goshen,1664,1,1,5,0,7,0.42
2011,56,Granby,4360,85,1,34,5,125,2.87
2011,57,Greenwich,25631,837,359,2,54,1252,4.88
2011,58,Griswold,5118,136,42,140,0,318,6.21
2011,59,Groton,17978,3267,56,337,10,3670,20.41
2011,60,Guilford,9596,168,5,28,0,201,2.09
2011,61,Haddam,3504,22,1,14,0,37,1.06
2011,62,Hamden,25114,684,514,448,4,1650,6.57
2011,63,Hampton,793,0,0,16,0,16,2.02
2011,64,Hartford,51822,9415,7577,1440,0,18432,35.57
2011,65,Hartland,856,2,0,4,0,6,0.70
2011,66,Harwinton,2282,23,1,21,0,45,1.97
2011,67,Hebron,3567,59,3,30,0,92,2.58
2011,68,Kent,1665,48,1,4,24,77,4.62
2011,69,Killingly,7592,530,124,251,0,905,11.92
2011,70,Killingworth,2598,0,1,5,5,11,0.42
2011,71,Lebanon,3125,26,5,47,0,78,2.50
2011,72,Ledyard,5987,32,7,158,0,197,3.29
2011,73,Lisbon,1730,2,0,35,0,37,2.14
2011,74,Litchfield,3975,140,2,11,29,182,4.58
2011,75,Lyme,1223,0,0,2,7,9,0.74
2011,76,Madison,8049,90,1,7,29,127,1.58
2011,77,Manchester,25996,1813,1011,883,36,3743,14.40
2011,78,Mansfield,6017,417,159,76,2,654,10.87
2011,79,Marlborough,2389,24,0,16,0,40,1.67
2011,80,Meriden,25892,1769,970,1022,11,3772,14.57
2011,81,Middlebury,2892,76,3,8,8,95,3.28
2011,82,Middlefield,1863,30,0,10,1,41,2.20
2011,83,Middletown,21223,2814,1295,590,25,4724,22.26
2011,84,Milford,23074,822,285,212,85,1404,6.08
2011,85,Monroe,6918,35,1,18,1,55,0.80
2011,86,Montville,7407,81,30,177,0,288,3.89
2011,87,Morris,1314,20,2,0,0,22,1.67
2011,88,Naugatuck,13061,492,273,301,0,1066,8.16
2011,89,New Britain,31226,3183,1457,1153,396,6189,19.82
2011,90,New Canaan,7551,140,10,2,31,183,2.42
2011,91,New Fairfield,5593,0,0,22,13,35,0.63
2011,92,New Hartford,2923,12,0,36,15,63,2.16
2011,93,New Haven,54967,8210,6116,1127,487,15940,29.00
2011,95,New London,11840,1672,155,457,69,2353,19.87
2011,96,New Milford,11731,233,221,107,16,577,4.92
2011,94,Newington,13011,426,84,366,36,912,7.01
2011,97,Newtown,10061,134,4,20,15,173,1.72
2011,98,Norfolk,967,28,0,3,0,31,3.21
2011,99,North Branford,5629,62,8,52,0,122,2.17
2011,100,North Canaan,1587,101,0,7,0,108,6.81
2011,101,North Haven,9491,343,29,74,1,447,4.71
2011,102,North Stonington,2306,0,1,17,0,18,0.78
2011,103,Norwalk,35415,2248,982,238,559,4027,11.37
2011,104,Norwich,18659,1906,707,517,0,3130,16.77
2011,105,Old Lyme,5021,60,1,5,3,69,1.37
2011,106,Old Saybrook,5602,50,5,15,1,71,1.27
2011,107,Orange,5345,46,4,9,0,59,1.10
2011,108,Oxford,4746,36,1,8,0,45,0.95
2011,109,Plainfield,6229,378,225,261,0,864,13.87
2011,110,Plainville,8063,223,24,302,53,602,7.47
2011,111,Plymouth,5109,179,5,142,0,326,6.38
2011,112,Pomfret,1684,32,2,11,0,45,2.67
2011,113,Portland,4077,185,91,48,0,324,7.95
2011,114,Preston,2019,40,3,34,0,77,3.81
2011,115,Prospect,3474,0,4,22,0,26,0.75
2011,116,Putnam,4299,383,64,101,0,548,12.75
2011,117,Redding,3811,0,0,0,0,0,0.00
2011,118,Ridgefield,9420,179,0,8,20,207,2.20
2011,119,Rocky Hill,8843,236,23,173,0,432,4.89
2011,120,Roxbury,1167,19,0,1,0,20,1.71
2011,121,Salem,1635,1,0,25,0,26,1.59
2011,122,Salisbury,2593,16,0,4,10,30,1.16
2011,123,Scotland,680,0,0,9,0,9,1.32
2011,124,Seymour,6968,262,25,83,0,370,5.31
2011,125,Sharon,1775,20,1,4,0,25,1.41
2011,126,Shelton,16146,254,16,83,82,435,2.69
2011,127,Sherman,1831,0,1,1,0,2,0.11
2011,128,Simsbury,9123,241,12,58,0,311,3.41
2011,129,Somers,3479,54,7,16,0,77,2.21
2011,132,South Windsor,10243,427,53,235,0,715,6.98
2011,130,Southbury,9091,89,2,12,0,103,1.13
2011,131,Southington,17447,609,41,281,51,982,5.63
2011,133,Sprague,1248,20,9,30,0,59,4.73
2011,134,Stafford,5124,178,12,140,0,330,6.44
2011,135,Stamford,50573,4618,1645,309,1221,7793,15.41
2011,136,Sterling,1511,0,3,21,9,33,2.18
2011,137,Stonington,9467,296,16,49,0,361,3.81
2011,138,Stratford,21091,524,365,259,33,1181,5.60
2011,139,Suffield,5469,212,0,41,15,268,4.90
2011,140,Thomaston,3276,105,3,83,0,191,5.83
2011,141,Thompson,4171,150,12,54,0,216,5.18
2011,142,Tolland,5451,97,2,69,3,171,3.14
2011,143,Torrington,16761,1082,301,611,17,2011,12.00
2011,144,Trumbull,13157,315,13,35,274,637,4.84
2011,145,Union,388,0,0,6,0,6,1.55
2011,146,Vernon,13896,1386,519,352,12,2269,16.33
2011,147,Voluntown,1127,20,2,21,0,43,3.82
2011,148,Wallingford,18945,482,141,299,35,957,5.05
2011,149,Warren,811,0,0,2,0,2,0.25
2011,150,Washington,2124,14,0,0,23,37,1.74
2011,151,Waterbury,47991,4870,3110,2256,333,10569,22.02
2011,152,Waterford,8634,123,13,192,0,328,3.80
2011,153,Watertown,9096,206,19,134,0,359,3.95
2011,155,West Hartford,26396,541,942,304,282,2069,7.84
2011,156,West Haven,22446,1024,1380,415,0,2819,12.56
2011,154,Westbrook,3937,140,7,13,24,184,4.67
2011,157,Weston,3674,0,1,0,0,1,0.03
2011,158,Westport,10399,245,20,2,15,282,2.71
2011,159,Wethersfield,11677,625,127,216,0,968,8.29
2011,160,Willington,2637,160,4,32,0,196,7.43
2011,161,Wilton,6475,84,4,7,70,165,2.55
2011,162,Winchester,5613,316,248,116,0,680,12.11
2011,163,Windham,9570,1692,560,427,0,2679,27.99
2011,164,Windsor,11767,154,245,379,0,778,6.61
2011,165,Windsor Locks,5429,137,149,182,0,468,8.62
2011,166,Wolcott,6276,312,4,121,0,437,6.96
2011,167,Woodbridge,3478,30,5,6,0,41,1.18
2011,168,Woodbury,4564,60,4,19,0,83,1.82
2011,169,Woodstock,3582,24,3,39,0,66,1.84
2021,1,Andover,1317,24,1,29,0,54,4.10
2021,2,Ansonia,8148,366,799,138,0,1303,15.99
2021,3,Ashford,1903,32,0,32,0,64,3.36
2021,4,Avon,7389,244,21,36,1,302,4.09
2021,5,Barkhamsted,1589,0,5,21,0,26,1.64
2021,6,Beacon Falls,2509,0,4,38,0,42,1.67
2021,7,Berlin,8140,556,50,124,4,734,9.02
2021,8,Bethany,2044,0,2,11,0,13,0.64
2021,9,Bethel,7310,192,30,132,87,441,6.03
2021,10,Bethlehem,1575,24,0,5,0,29,1.84
2021,11,Bloomfield,9019,574,114,303,0,991,10.99
2021,12,Bolton,2015,0,2,29,0,31,1.54
2021,13,Bozrah,1059,0,3,27,0,30,2.83
2021,14,Branford,13972,243,73,152,9,477,3.41
2021,15,Bridgeport,57012,6949,4351,815,19,12134,21.28
2021,16,Bridgewater,881,0,0,1,0,1,0.11
2021,17,Bristol,27011,2006,950,1031,0,3987,14.76
2021,18,Brookfield,6562,155,22,97,77,351,5.35
2021,19,Brooklyn,3235,232,10,63,0,305,9.43
2021,20,Burlington,3389,27,0,44,0,71,2.10
2021,21,Canaan,779,1,3,4,1,9,1.16
2021,22,Canterbury,2043,76,1,61,0,138,6.75
2021,23,Canton,4339,251,31,48,32,362,8.34
2021,24,Chaplin,988,0,2,35,0,37,3.74
2021,25,Cheshire,10424,258,23,88,17,386,3.70
2021,26,Chester,1923,23,4,15,0,42,2.18
2021,27,Clinton,6065,105,8,60,0,173,2.85
2021,28,Colchester,6182,364,37,132,4,537,8.69
2021,29,Colebrook,722,0,1,6,1,8,1.11
2021,30,Columbia,2308,24,2,57,0,83,3.60
2021,31,Cornwall,1007,28,2,6,0,36,3.57
2021,32,Coventry,5099,103,4,120,20,247,4.84
2021,33,Cromwell,6001,212,9,173,0,394,6.57
2021,34,Danbury,31154,1652,1258,465,221,3596,11.54
2021,35,Darien,7074,161,14,2,104,281,3.97
2021,36,Deep River,2096,26,6,32,0,64,3.05
2021,37,Derby,5849,275,314,102,0,691,11.81
2021,38,Durham,2694,36,1,26,0,63,2.34
2021,40,East Granby,2152,72,2,42,0,116,5.39
2021,41,East Haddam,4508,73,2,59,0,134,2.97
2021,42,East Hampton,5485,64,7,83,25,179,3.26
2021,43,East Hartford,21328,1593,809,964,0,3366,15.78
2021,44,East Haven,12533,542,167,274,0,983,7.84
2021,45,East Lyme,8458,396,19,86,19,520,6.15
2021,47,East Windsor,5045,559,37,102,0,698,13.84
2021,39,Eastford,793,0,0,10,0,10,1.26
2021,46,Easton,2715,0,0,3,15,18,0.66
2021,48,Ellington,6665,260,5,104,0,369,5.54
2021,49,Enfield,17558,1360,221,592,7,2180,12.42
2021,50,Essex,3261,75,2,16,16,109,3.34
2021,51,Fairfield,21648,231,139,56,182,608,2.81
2021,52,Farmington,11106,470,115,128,155,868,7.82
2021,53,Franklin,771,27,2,19,0,48,6.23
2021,54,Glastonbury,13656,604,49,108,2,763,5.59
2021,55,Goshen,1664,1,1,4,0,6,0.36
2021,56,Granby,4360,85,2,46,5,138,3.17
2021,57,Greenwich,25631,879,458,13,38,1388,5.42
2021,58,Griswold,5118,222,57,144,0,423,8.26
2021,59,Groton,17978,3727,103,335,10,4175,23.22
2021,60,Guilford,9596,186,10,32,0,228,2.38
2021,61,Haddam,3504,22,1,27,0,50,1.43
2021,62,Hamden,25114,1048,818,473,4,2343,9.33
2021,63,Hampton,793,0,1,11,0,12,1.51
2021,64,Hartford,51822,10733,8723,1441,0,20897,40.32
2021,65,Hartland,856,2,0,6,0,8,0.93
2021,66,Harwinton,2282,22,6,34,5,67,2.94
2021,67,Hebron,3567,58,3,44,0,105,2.94
2021,68,Kent,1665,58,4,4,0,66,3.96
2021,69,Killingly,7592,467,152,167,0,786,10.35
2021,70,Killingworth,2598,0,0,16,5,21,0.81
2021,71,Lebanon,3125,26,3,76,0,105,3.36
2021,72,Ledyard,5987,32,12,210,6,260,4.34
2021,73,Lisbon,1730,2,0,58,0,60,3.47
2021,74,Litchfield,3975,140,3,30,19,192,4.83
2021,75,Lyme,1223,0,0,5,8,13,1.06
2021,76,Madison,8049,90,3,9,33,135,1.68
2021,77,Manchester,25996,1871,979,872,32,3754,14.44
2021,78,Mansfield,6017,175,128,80,2,385,6.40
2021,79,Marlborough,2389,24,0,24,0,48,2.01
2021,80,Meriden,25892,1976,1360,956,11,4303,16.62
2021,81,Middlebury,2892,77,5,18,20,120,4.15
2021,82,Middlefield,1863,30,3,18,1,52,2.79
2021,83,Middletown,21223,3116,1129,486,25,4756,22.41
2021,84,Milford,23074,728,244,168,74,1214,5.26
2021,85,Monroe,6918,35,5,44,8,92,1.33
2021,86,Montville,7407,81,54,247,0,382,5.16
2021,87,Morris,1314,20,3,5,0,28,2.13
2021,88,Naugatuck,13061,493,305,344,0,1142,8.74
2021,89,New Britain,31226,3017,1583,1109,100,5809,18.60
2021,90,New Canaan,7551,175,19,5,21,220,2.91
2021,91,New Fairfield,5593,0,2,53,17,72,1.29
2021,92,New Hartford,2923,12,3,47,15,77,2.63
2021,93,New Haven,54967,9652,7142,891,457,18142,33.01
2021,95,New London,11840,1600,490,475,101,2666,22.52
2021,96,New Milford,11731,319,41,153,20,533,4.54
2021,94,Newington,13011,531,128,437,36,1132,8.70
2021,97,Newtown,10061,134,7,80,32,253,2.51
2021,98,Norfolk,967,21,1,5,0,27,2.79
2021,99,North Branford,5629,62,14,45,0,121,2.15
2021,100,North Canaan,1587,148,0,14,0,162,10.21
2021,101,North Haven,9491,393,51,85,23,552,5.82
2021,102,North Stonington,2306,0,1,21,6,28,1.21
2021,103,Norwalk,35415,2245,1546,385,667,4843,13.67
2021,104,Norwich,18659,2296,796,516,0,3608,19.34
2021,105,Old Lyme,5021,64,2,14,3,83,1.65
2021,106,Old Saybrook,5602,52,15,21,73,161,2.87
2021,107,Orange,5345,46,10,10,6,72,1.35
2021,108,Oxford,4746,36,3,26,0,65,1.37
2021,109,Plainfield,6229,377,196,191,4,768,12.33
2021,110,Plainville,8063,205,46,282,22,555,6.88
2021,111,Plymouth,5109,178,20,174,0,372,7.28
2021,112,Pomfret,1684,32,2,13,0,47,2.79
2021,113,Portland,4077,185,90,64,0,339,8.31
2021,114,Preston,2019,40,5,38,0,83,4.11
2021,115,Prospect,3474,0,4,43,45,92,2.65
2021,116,Putnam,4299,413,63,70,0,546,12.70
2021,117,Redding,3811,0,2,15,0,17,0.45
2021,118,Ridgefield,9420,175,6,26,79,286,3.04
2021,119,Rocky Hill,8843,235,62,157,0,454,5.13
2021,120,Roxbury,1167,19,0,5,0,24,2.06
2021,121,Salem,1635,0,4,30,0,34,2.08
2021,122,Salisbury,2593,24,0,2,14,40,1.54
2021,123,Scotland,680,0,1,28,0,29,4.26
2021,124,Seymour,6968,262,29,98,0,389,5.58
2021,125,Sharon,1775,32,1,3,0,36,2.03
2021,126,Shelton,16146,254,40,118,82,494,3.06
2021,127,Sherman,1831,0,1,6,0,7,0.38
2021,128,Simsbury,9123,289,63,86,0,438,4.80
2021,129,Somers,3479,146,7,33,0,186,5.35
2021,132,South Windsor,10243,443,57,186,12,698,6.81
2021,130,Southbury,9091,90,7,31,0,128,1.41
2021,131,Southington,17447,499,62,317,54,932,5.34
2021,133,Sprague,1248,20,12,24,1,57,4.57
2021,134,Stafford,5124,257,20,115,0,392,7.65
2021,135,Stamford,50573,4219,2073,383,1270,7945,15.71
2021,136,Sterling,1511,0,6,21,0,27,1.79
2021,137,Stonington,9467,441,19,79,2,541,5.71
2021,138,Stratford,21091,524,425,344,33,1326,6.29
2021,139,Suffield,5469,296,6,48,15,365,6.67
2021,140,Thomaston,3276,104,5,97,0,206,6.29
2021,141,Thompson,4171,151,13,42,0,206,4.94
2021,142,Tolland,5451,127,12,95,3,237,4.35
2021,143,Torrington,16761,912,328,513,17,1770,10.56
2021,144,Trumbull,13157,315,19,82,315,731,5.56
2021,145,Union,388,0,0,6,0,6,1.55
2021,146,Vernon,13896,1509,470,348,12,2339,16.83
2021,147,Voluntown,1127,20,1,22,0,43,3.82
2021,148,Wallingford,18945,354,142,296,35,827,4.37
2021,149,Warren,811,0,0,1,0,1,0.12
2021,150,Washington,2124,17,2,3,23,45,2.12
2021,151,Waterbury,47991,5385,3156,1597,48,10186,21.22
2021,152,Waterford,8634,213,33,239,0,485,5.62
2021,153,Watertown,9096,205,33,216,0,454,4.99
2021,155,West Hartford,26396,643,852,320,250,2065,7.82
2021,156,West Haven,22446,1024,2119,395,0,3538,15.76
2021,154,Westbrook,3937,140,5,29,29,203,5.16
2021,157,Weston,3674,0,2,6,0,8,0.22
2021,158,Westport,10399,265,60,2,63,390,3.75
2021,159,Wethersfield,11677,705,109,258,0,1072,9.18
2021,160,Willington,2637,160,6,35,0,201,7.62
2021,161,Wilton,6475,158,9,14,51,232,3.58
2021,162,Winchester,5613,350,170,84,0,604,10.76
2021,163,Windham,9570,1776,597,338,0,2711,28.33
2021,164,Windsor,11767,154,288,420,26,888,7.55
2021,165,Windsor Locks,5429,297,154,224,0,675,12.43
2021,166,Wolcott,6276,313,14,174,0,501,7.98
2021,167,Woodbridge,3478,30,8,3,0,41,1.18
2021,168,Woodbury,4564,60,4,27,0,91,1.99
2021,169,Woodstock,3582,24,0,28,0,52,1.45
2022,2,Ansonia,8148,230,816,132,0,1178,14.46
2022,11,Bloomfield,9019,612,115,277,0,1004,11.13
2022,15,Bridgeport,57012,7020,4321,744,15,12100,21.22
2022,17,Bristol,27011,2006,965,963,0,3934,14.56
2022,34,Danbury,31154,1652,1292,390,210,3544,11.38
2022,37,Derby,5849,275,316,89,0,680,11.63
2022,43,East Hartford,21328,1593,826,919,0,3338,15.65
2022,47,East Windsor,5045,559,43,102,0,704,13.95
2022,49,Enfield,17558,1360,231,544,7,2142,12.20
2022,59,Groton,17978,3727,100,312,10,4149,23.08
2022,64,Hartford,51822,10620,9132,1370,0,21122,40.76
2022,69,Killingly,7592,467,160,141,0,768,10.12
2022,77,Manchester,25996,1864,1011,821,32,3728,14.34
2022,80,Meriden,25892,2057,1426,905,11,4399,16.99
2022,83,Middletown,21223,3118,1167,443,25,4753,22.40
2022,89,New Britain,31226,3017,1692,1048,91,5848,18.73
2022,93,New Haven,54967,9621,7498,833,391,18343,33.37
2022,95,New London,11840,1620,501,448,131,2700,22.80
2022,103,Norwalk,35415,2423,1619,345,698,5085,14.36
2022,104,Norwich,18659,2350,767,499,0,3616,19.38
2022,109,Plainfield,6229,429,192,169,4,794,12.75
2022,116,Putnam,4299,413,69,61,0,543,12.63
2022,135,Stamford,50573,4217,2033,345,1268,7863,15.55
2022,143,Torrington,16761,912,322,482,17,1733,10.34
2022,146,Vernon,13896,1509,464,322,12,2307,16.60
2022,151,Waterbury,47991,5385,3205,1478,39,10107,21.06
2022,156,West Haven,22446,1024,2112,350,0,3486,15.53
2022,163,Windham,9570,1776,586,310,0,2672,27.92
2022,165,Windsor Locks,5429,297,166,206,0,669,12.32
2022,1,Andover,1317,24,1,27,0,52,3.95
2022,3,Ashford,1903,32,0,30,0,62,3.26
2022,4,Avon,7389,244,24,29,2,299,4.05
2022,5,Barkhamsted,1589,0,5,21,0,26,1.64
2022,6,Beacon Falls,2509,0,6,33,0,39,1.55
2022,7,Berlin,8140,556,48,108,4,716,8.80
2022,8,Bethany,2044,0,2,8,0,10,0.49
2022,9,Bethel,7310,192,34,119,84,429,5.87
2022,10,Bethlehem,1575,24,0,4,0,28,1.78
2022,12,Bolton,2015,0,0,28,0,28,1.39
2022,13,Bozrah,1059,0,3,24,0,27,2.55
2022,14,Branford,13972,243,65,129,9,446,3.19
2022,16,Bridgewater,881,0,0,1,0,1,0.11
2022,18,Brookfield,6562,155,23,83,112,373,5.68
2022,19,Brooklyn,3235,205,13,59,0,277,8.56
2022,20,Burlington,3389,27,0,44,0,71,2.10
2022,21,Canaan,779,1,2,4,3,10,1.28
2022,22,Canterbury,2043,76,0,51,0,127,6.22
2022,23,Canton,4339,251,32,45,32,360,8.30
2022,24,Chaplin,988,0,3,30,0,33,3.34
2022,25,Cheshire,10424,258,21,73,17,369,3.54
2022,26,Chester,1923,23,4,12,0,39,2.03
2022,27,Clinton,6065,105,8,57,0,170,2.80
2022,28,Colchester,6182,364,38,116,4,522,8.44
2022,29,Colebrook,722,0,0,7,1,8,1.11
2022,30,Columbia,2308,24,2,42,0,68,2.95
2022,31,Cornwall,1007,28,2,6,0,36,3.57
2022,32,Coventry,5099,103,3,113,20,239,4.69
2022,33,Cromwell,6001,212,9,151,0,372,6.20
2022,35,Darien,7074,161,17,1,117,296,4.18
2022,36,Deep River,2096,44,7,28,0,79,3.77
2022,38,Durham,2694,36,1,22,0,59,2.19
2022,40,East Granby,2152,72,2,35,0,109,5.07
2022,41,East Haddam,4508,73,1,47,0,121,2.68
2022,42,East Hampton,5485,70,8,76,25,179,3.26
2022,44,East Haven,12533,612,166,259,0,1037,8.27
2022,45,East Lyme,8458,452,24,75,19,570,6.74
2022,39,Eastford,793,0,0,9,0,9,1.13
2022,46,Easton,2715,0,0,3,14,17,0.63
2022,48,Ellington,6665,260,6,89,0,355,5.33
2022,50,Essex,3261,75,1,15,16,107,3.28
2022,51,Fairfield,21648,231,138,57,199,625,2.89
2022,52,Farmington,11106,538,122,108,155,923,8.31
2022,53,Franklin,771,27,1,18,0,46,5.97
2022,54,Glastonbury,13656,604,55,97,2,758,5.55
2022,55,Goshen,1664,1,1,3,0,5,0.30
2022,56,Granby,4360,85,3,39,5,132,3.03
2022,57,Greenwich,25631,921,473,11,47,1452,5.67
2022,58,Griswold,5118,222,61,119,0,402,7.85
2022,60,Guilford,9596,177,11,30,1,219,2.28
2022,61,Haddam,3504,22,1,24,0,47,1.34
2022,62,Hamden,25114,1048,826,429,4,2307,9.19
2022,63,Hampton,793,0,1,9,0,10,1.26
2022,65,Hartland,856,2,0,3,0,5,0.58
2022,66,Harwinton,2282,22,6,31,5,64,2.80
2022,67,Hebron,3567,58,2,42,0,102,2.86
2022,68,Kent,1665,58,3,3,0,64,3.84
2022,70,Killingworth,2598,0,1,16,2,19,0.73
2022,71,Lebanon,3125,26,3,69,0,98,3.14
2022,72,Ledyard,5987,32,10,191,6,239,3.99
2022,73,Lisbon,1730,2,0,52,0,54,3.12
2022,74,Litchfield,3975,140,3,26,19,188,4.73
2022,75,Lyme,1223,0,0,3,8,11,0.90
2022,76,Madison,8049,90,3,8,29,130,1.62
2022,78,Mansfield,6017,175,130,72,2,379,6.30
2022,79,Marlborough,2389,24,0,18,0,42,1.76
2022,81,Middlebury,2892,77,4,14,20,115,3.98
2022,82,Middlefield,1863,30,5,19,1,55,2.95
2022,84,Milford,23074,728,235,138,74,1175,5.09
2022,85,Monroe,6918,35,5,36,8,84,1.21
2022,86,Montville,7407,81,54,233,0,368,4.97
2022,87,Morris,1314,20,1,5,0,26,1.98
2022,88,Naugatuck,13061,493,312,312,0,1117,8.55
2022,90,New Canaan,7551,175,19,6,0,200,2.65
2022,91,New Fairfield,5593,0,4,45,17,66,1.18
2022,92,New Hartford,2923,12,4,40,15,71,2.43
2022,96,New Milford,11731,319,42,139,20,520,4.43
2022,94,Newington,13011,531,122,418,36,1107,8.51
2022,97,Newtown,10061,134,6,74,59,273,2.71
2022,98,Norfolk,967,21,2,5,0,28,2.90
2022,99,North Branford,5629,62,15,45,0,122,2.17
2022,100,North Canaan,1587,111,0,15,0,126,7.94
2022,101,North Haven,9491,393,53,77,23,546,5.75
2022,102,North Stonington,2306,0,1,18,6,25,1.08
2022,105,Old Lyme,5021,64,2,10,3,79,1.57
2022,106,Old Saybrook,5602,52,15,21,73,161,2.87
2022,107,Orange,5345,46,10,10,6,72,1.35
2022,108,Oxford,4746,36,3,24,0,63,1.33
2022,110,Plainville,8063,205,61,262,22,550,6.82
2022,111,Plymouth,5109,178,19,164,0,361,7.07
2022,112,Pomfret,1684,32,2,11,0,45,2.67
2022,113,Portland,4077,185,87,54,0,326,8.00
2022,114,Preston,2019,40,6,36,0,82,4.06
2022,115,Prospect,3474,0,4,40,55,99,2.85
2022,117,Redding,3811,0,3,14,0,17,0.45
2022,118,Ridgefield,9420,175,6,23,79,283,3.00
2022,119,Rocky Hill,8843,235,63,138,0,436,4.93
2022,120,Roxbury,1167,19,0,4,0,23,1.97
2022,121,Salem,1635,0,2,27,0,29,1.77
2022,122,Salisbury,2593,24,1,1,14,40,1.54
2022,123,Scotland,680,0,1,25,0,26,3.82
2022,124,Seymour,6968,262,31,94,0,387,5.55
2022,125,Sharon,1775,32,1,2,0,35,1.97
2022,126,Shelton,16146,322,42,104,82,550,3.41
2022,127,Sherman,1831,0,1,5,0,6,0.33
2022,128,Simsbury,9123,289,60,86,28,463,5.08
2022,129,Somers,3479,146,7,31,0,184,5.29
2022,132,South Windsor,10243,443,53,155,12,663,6.47
2022,130,Southbury,9091,90,6,27,0,123,1.35
2022,131,Southington,17447,499,61,299,53,912,5.23
2022,133,Sprague,1248,20,10,21,1,52,4.17
2022,134,Stafford,5124,257,18,103,0,378,7.38
2022,136,Sterling,1511,0,6,20,0,26,1.72
2022,137,Stonington,9467,484,23,66,2,575,6.07
2022,138,Stratford,21091,524,436,310,33,1303,6.18
2022,139,Suffield,5469,296,6,45,6,353,6.45
2022,140,Thomaston,3276,104,6,95,0,205,6.26
2022,141,Thompson,4171,151,15,36,0,202,4.84
2022,142,Tolland,5451,127,12,94,3,236,4.33
2022,144,Trumbull,13157,315,17,68,316,716,5.44
2022,145,Union,388,0,0,6,0,6,1.55
2022,147,Voluntown,1127,20,1,19,0,40,3.55
2022,148,Wallingford,18945,354,149,264,35,802,4.23
2022,149,Warren,811,0,0,0,0,0,0.00
2022,150,Washington,2124,17,2,2,28,49,2.31
2022,152,Waterford,8634,213,37,224,0,474,5.49
2022,153,Watertown,9096,205,33,200,0,438,4.82
2022,155,West Hartford,26396,643,798,276,245,1962,7.43
2022,154,Westbrook,3937,140,6,25,29,200,5.08
2022,157,Weston,3674,0,1,5,0,6,0.16
2022,158,Westport,10399,265,54,2,72,393,3.78
2022,159,Wethersfield,11677,705,102,243,0,1050,8.99
2022,160,Willington,2637,160,7,34,0,201,7.62
2022,161,Wilton,6475,158,10,12,51,231,3.57
2022,162,Winchester,5613,269,157,83,0,509,9.07
2022,164,Windsor,11767,154,261,401,26,842,7.16
2022,166,Wolcott,6276,313,11,157,0,481,7.66
2022,167,Woodbridge,3478,30,6,4,0,40,1.15
2022,168,Woodbury,4564,60,6,26,0,92,2.02
2022,169,Woodstock,3582,24,0,24,0,48,1.34
2023,1,Andover,1324,24,1,26,0,51,3.85
2023,2,Ansonia,8104,232,818,137,0,1187,14.65
2023,3,Ashford,1923,32,0,30,0,62,3.22
2023,4,Avon,7713,244,25,30,2,301,3.90
2023,5,Barkhamsted,1566,0,5,23,0,28,1.79
2023,6,Beacon Falls,2618,0,7,42,0,49,1.87
2023,7,Berlin,8571,556,46,118,4,724,8.45
2023,8,Bethany,2039,0,2,9,0,11,0.54
2023,9,Bethel,7980,192,26,117,83,418,5.24
2023,10,Bethlehem,1605,24,0,4,0,28,1.74
2023,11,Bloomfield,9717,612,138,285,0,1035,10.65
2023,12,Bolton,2045,0,1,34,0,35,1.71
2023,13,Bozrah,1131,0,2,24,0,26,2.30
2023,14,Branford,14180,243,64,124,9,440,3.10
2023,15,Bridgeport,58874,7027,4385,750,12,12174,20.68
2023,16,Bridgewater,863,0,0,1,0,1,0.12
2023,17,Bristol,27251,2006,966,1004,0,3976,14.59
2023,18,Brookfield,7116,155,26,78,112,371,5.21
2023,19,Brooklyn,3342,205,11,53,0,269,8.05
2023,20,Burlington,3628,27,0,46,0,73,2.01
2023,21,Canaan,639,1,2,4,3,10,1.56
2023,22,Canterbury,2044,76,1,50,0,127,6.21
2023,23,Canton,4383,251,32,45,32,360,8.21
2023,24,Chaplin,955,0,1,26,0,27,2.83
2023,25,Cheshire,10401,258,15,76,17,366,3.52
2023,26,Chester,1793,23,4,12,0,39,2.18
2023,27,Clinton,6283,105,8,58,0,171,2.72
2023,28,Colchester,6441,364,39,124,4,531,8.24
2023,29,Colebrook,694,0,0,6,1,7,1.01
2023,30,Columbia,2294,24,2,47,0,73,3.18
2023,31,Cornwall,1002,28,2,6,0,36,3.59
2023,32,Coventry,5273,103,3,115,20,241,4.57
2023,33,Cromwell,6162,212,11,154,0,377,6.12
2023,34,Danbury,33562,1652,1297,368,210,3527,10.51
2023,35,Darien,7265,161,18,1,117,297,4.09
2023,36,Deep River,2112,44,7,28,0,79,3.74
2023,37,Derby,5759,275,323,101,0,699,12.14
2023,38,Durham,2828,36,0,23,0,59,2.09
2023,39,Eastford,806,0,1,10,0,11,1.36
2023,40,East Granby,2183,72,2,37,0,111,5.08
2023,41,East Haddam,4477,73,2,51,0,126,2.81
2023,42,East Hampton,5637,70,5,81,25,181,3.21
2023,43,East Hartford,21361,1593,788,973,0,3354,15.70
2023,44,East Haven,12394,612,165,255,0,1032,8.33
2023,45,East Lyme,9080,452,23,76,19,570,6.28
2023,46,Easton,2756,0,0,4,10,14,0.51
2023,47,East Windsor,5348,559,40,102,0,701,13.11
2023,48,Ellington,7054,260,6,98,0,364,5.16
2023,49,Enfield,17741,1360,232,565,7,2164,12.20
2023,50,Essex,3329,75,1,15,16,107,3.21
2023,51,Fairfield,21982,231,163,58,219,671,3.05
2023,52,Farmington,11667,538,129,115,155,937,8.03
2023,53,Franklin,790,27,1,19,0,47,5.95
2023,54,Glastonbury,14481,604,57,95,2,758,5.23
2023,55,Goshen,1708,1,1,4,0,6,0.35
2023,56,Granby,4448,85,2,43,3,133,2.99
2023,57,Greenwich,25677,940,475,10,47,1472,5.73
2023,58,Griswold,5027,222,60,119,0,401,7.98
2023,59,Groton,18154,3727,97,313,10,4147,22.84
2023,60,Guilford,9693,177,10,27,1,215,2.22
2023,61,Haddam,3540,22,1,23,0,46,1.30
2023,62,Hamden,25984,1048,838,439,117,2442,9.40
2023,63,Hampton,790,0,1,10,0,11,1.39
2023,64,Hartford,53259,10755,8991,1419,0,21165,39.74
2023,65,Hartland,843,2,0,3,0,5,0.59
2023,66,Harwinton,2313,22,6,35,5,68,2.94
2023,67,Hebron,3618,58,2,48,0,108,2.99
2023,68,Kent,1687,58,3,3,0,64,3.79
2023,69,Killingly,7884,467,145,134,0,746,9.46
2023,70,Killingworth,2601,0,1,18,1,20,0.77
2023,71,Lebanon,3147,26,6,75,0,107,3.40
2023,72,Ledyard,6150,32,8,189,6,235,3.82
2023,73,Lisbon,1728,2,0,52,0,54,3.13
2023,74,Litchfield,3966,140,4,26,19,189,4.77
2023,75,Lyme,1220,0,0,3,8,11,0.90
2023,76,Madison,8060,90,3,8,29,130,1.61
2023,77,Manchester,26445,1864,981,834,32,3711,14.03
2023,78,Mansfield,6956,175,124,75,2,376,5.41
2023,79,Marlborough,2388,24,0,22,0,46,1.93
2023,80,Meriden,26177,2057,1466,932,11,4466,17.06
2023,81,Middlebury,3047,77,5,12,20,114,3.74
2023,82,Middlefield,1882,30,5,21,1,57,3.03
2023,83,Middletown,21671,3048,1137,458,25,4668,21.54
2023,84,Milford,23749,728,315,140,74,1257,5.29
2023,85,Monroe,6918,35,3,38,8,84,1.21
2023,86,Montville,7402,81,49,243,0,373,5.04
2023,87,Morris,1253,20,0,5,0,25,2.00
2023,88,Naugatuck,13239,493,296,313,0,1102,8.32
2023,89,New Britain,31510,3041,1689,1106,89,5925,18.80
2023,90,New Canaan,7502,255,33,7,0,295,3.93
2023,91,New Fairfield,5635,0,7,49,16,72,1.28
2023,92,New Hartford,2968,12,6,38,9,65,2.19
2023,93,New Haven,57525,9652,7632,822,354,18460,32.09
2023,94,Newington,13219,531,121,446,36,1134,8.58
2023,95,New London,12119,1648,491,470,175,2784,22.97
2023,96,New Milford,11928,319,36,135,29,519,4.35
2023,97,Newtown,10322,134,7,77,65,283,2.74
2023,98,Norfolk,932,21,2,5,0,28,3.00
2023,99,North Branford,5633,62,12,45,0,119,2.11
2023,100,North Canaan,1582,111,0,9,0,120,7.59
2023,101,North Haven,9981,393,50,81,23,547,5.48
2023,102,North Stonington,2226,0,2,18,8,28,1.26
2023,103,Norwalk,38152,2434,1578,346,732,5090,13.34
2023,104,Norwich,18769,2350,813,518,0,3681,19.61
2023,105,Old Lyme,4988,64,2,11,3,80,1.60
2023,106,Old Saybrook,5870,52,14,21,73,160,2.73
2023,107,Orange,5480,46,10,10,6,72,1.31
2023,108,Oxford,5022,36,4,25,0,65,1.29
2023,109,Plainfield,6264,429,188,164,4,785,12.53
2023,110,Plainville,8045,205,56,275,22,558,6.94
2023,111,Plymouth,5151,178,22,169,0,369,7.16
2023,112,Pomfret,1686,32,2,11,0,45,2.67
2023,113,Portland,4128,120,85,55,0,260,6.30
2023,114,Preston,2049,40,6,35,0,81,3.95
2023,115,Prospect,3762,0,4,43,55,102,2.71
2023,116,Putnam,4292,536,71,59,0,666,15.52
2023,117,Redding,3664,0,3,13,0,16,0.44
2023,118,Ridgefield,9506,175,6,21,79,281,2.96
2023,119,Rocky Hill,9319,235,66,135,0,436,4.68
2023,120,Roxbury,1163,19,0,4,0,23,1.98
2023,121,Salem,1719,0,2,24,0,26,1.51
2023,122,Salisbury,2519,24,1,1,14,40,1.59
2023,123,Scotland,650,0,0,23,0,23,3.54
2023,124,Seymour,7112,262,33,98,0,393,5.53
2023,125,Sharon,1724,32,1,2,0,35,2.03
2023,126,Shelton,17174,322,61,110,82,575,3.35
2023,127,Sherman,1834,0,1,5,0,6,0.33
2023,128,Simsbury,10057,289,63,92,28,472,4.69
2023,129,Somers,3622,146,7,33,0,186,5.14
2023,130,Southbury,9270,90,7,27,0,124,1.34
2023,131,Southington,18145,499,67,312,56,934,5.15
2023,132,South Windsor,10804,443,51,171,12,677,6.27
2023,133,Sprague,1268,20,10,23,1,54,4.26
2023,134,Stafford,5237,257,22,105,0,384,7.33
2023,135,Stamford,56953,4262,2062,344,1268,7936,13.93
2023,136,Sterling,1479,0,7,22,0,29,1.96
2023,137,Stonington,9447,484,21,66,14,585,6.19
2023,138,Stratford,21643,524,424,326,33,1307,6.04
2023,139,Suffield,5879,296,5,52,4,357,6.07
2023,140,Thomaston,3340,104,7,96,0,207,6.20
2023,141,Thompson,4143,151,15,36,0,202,4.88
2023,142,Tolland,5630,127,9,97,3,236,4.19
2023,143,Torrington,17040,972,334,526,17,1849,10.85
2023,144,Trumbull,13159,315,15,71,284,685,5.21
2023,145,Union,377,0,0,5,0,5,1.33
2023,146,Vernon,14761,1509,482,326,12,2329,15.78
2023,147,Voluntown,1135,20,2,21,0,43,3.79
2023,148,Wallingford,18938,354,150,261,35,800,4.22
2023,149,Warren,790,0,0,1,0,1,0.13
2023,150,Washington,2056,17,1,3,28,49,2.38
2023,151,Waterbury,48392,5385,3326,1542,39,10292,21.27
2023,152,Waterford,8873,213,39,220,0,472,5.32
2023,153,Watertown,9137,205,33,216,0,454,4.97
2023,154,Westbrook,3976,140,7,25,29,201,5.06
2023,155,West Hartford,27240,695,857,286,245,2083,7.65
2023,156,West Haven,22735,1024,2172,351,0,3547,15.60
2023,157,Weston,3671,0,1,5,0,6,0.16
2023,158,Westport,10567,265,57,1,75,398,3.77
2023,159,Wethersfield,11809,705,110,251,0,1066,9.03
2023,160,Willington,2685,184,7,33,0,224,8.34
2023,161,Wilton,6567,158,12,12,51,233,3.55
2023,162,Winchester,5405,269,147,96,0,512,9.47
2023,163,Windham,9663,1776,591,306,0,2673,27.66
2023,164,Windsor,12038,154,249,420,26,849,7.05
2023,165,Windsor Locks,5815,297,169,221,0,687,11.81
2023,166,Wolcott,6408,313,7,164,0,484,7.55
2023,167,Woodbridge,3476,30,6,4,0,40,1.15
2023,168,Woodbury,4584,60,4,30,0,94,2.05
2023,169,Woodstock,3669,24,1,23,0,48,1.31
